fips,place,state,hs_total,hs_occupied,hs_vacant
3700160,Aberdeen,NC,3879,3594,285
3700440,Advance,NC,631,586,45
3700500,Ahoskie,NC,2326,2015,311
3700640,Alamance,NC,400,381,19
3700680,Albemarle,NC,7511,6763,748
3700880,Alexis,NC,276,242,34
3701000,Alliance,NC,328,282,46
3701140,Altamahaw,NC,150,139,11
3701340,Anderson Creek,NC,5175,4749,426
3701380,Andrews,NC,895,707,188
3701400,Angier,NC,2162,2025,137
3701420,Ansonville,NC,213,182,31
3701520,Apex,NC,22151,20851,1300
3701560,Aquadale,NC,169,150,19
3701640,Arapahoe,NC,219,190,29
3701720,Archdale,NC,5138,4905,233
3701760,Archer Lodge,NC,1707,1646,61
3701972,Arrowhead Beach,NC,487,322,165
3702080,Asheboro,NC,11855,10929,926
3702140,Asheville,NC,47606,43216,4390
3702240,Ashley Heights,NC,150,133,17
3702320,Askewville,NC,97,88,9
3702460,Atkinson,NC,126,108,18
3702480,Atlantic,NC,374,224,150
3702500,Atlantic Beach,NC,4844,809,4035
3702580,Aulander,NC,403,318,85
3702620,Aurora,NC,275,205,70
3702700,Autryville,NC,98,91,7
3702760,Avery Creek,NC,917,858,59
3702780,Avon,NC,1631,413,1218
3702840,Ayden,NC,2516,2206,310
3702960,Badin,NC,605,525,80
3703020,Bailey,NC,246,211,35
3703100,Bakersville,NC,244,196,48
3703150,Bald Head Island,NC,1050,142,908
3703220,Balfour,NC,595,531,64
3703500,Banner Elk,NC,622,292,330
3703640,Barker Heights,NC,502,455,47
3703665,Barker Ten Mile,NC,391,373,18
3703720,Barnardsville,NC,255,227,28
3703840,Bath,NC,163,122,41
3703960,Bayboro,NC,312,249,63
3704015,Bayshore,NC,1583,1493,90
3704040,Bayview,NC,264,148,116
3704180,Bear Grass,NC,41,41,0
3704260,Beaufort,NC,3094,2273,821
3704510,Beech Mountain,NC,2356,348,2008
3704640,Belhaven,NC,893,701,192
3704680,Bell Arthur,NC,190,177,13
3704840,Belmont,NC,6426,5936,490
3704950,Belville,NC,1014,963,51
3704955,Belvoir,NC,120,113,7
3704960,Belwood,NC,426,369,57
3705020,Bennett,NC,137,124,13
3705040,Benson,NC,1763,1575,188
3705049,Bent Creek,NC,609,576,33
3705135,Bermuda Run,NC,1593,1477,116
3705220,Bessemer City,NC,2445,2230,215
3705340,Bethania,NC,168,153,15
3705460,Bethel,NC,700,594,106
3705530,Bethlehem,NC,2014,1863,151
3705660,Beulaville,NC,648,552,96
3705880,Biltmore Forest,NC,683,578,105
3706000,Biscoe,NC,669,625,44
3706080,Black Creek,NC,318,271,47
3706140,Black Mountain,NC,4476,3906,570
3706240,Bladenboro,NC,851,747,104
3706500,Blowing Rock,NC,2084,684,1400
3706510,Blue Clay Farms,NC,72,72,0
3706660,Boardman,NC,82,60,22
3706740,Bogue,NC,319,284,35
3706760,Boiling Spring Lakes,NC,2605,2403,202
3706800,Boiling Springs,NC,1465,1401,64
3706820,Bolivia,NC,69,55,14
3706860,Bolton,NC,273,211,62
3706980,Bonnetsville,NC,151,131,20
3707080,Boone,NC,7217,6251,966
3707140,Boonville,NC,555,506,49
3707220,Bostic,NC,180,156,24
3707340,Bowdens,NC,116,66,50
3707400,Bowmore,NC,43,36,7
3707588,Brandywine Bay,NC,629,569,60
3707720,Brevard,NC,3935,3427,508
3707748,Briar Chapel,NC,1955,1882,73
3707765,Brices Creek,NC,1370,1300,70
3707860,Bridgeton,NC,217,144,73
3708040,Broad Creek,NC,1287,809,478
3708080,Broadway,NC,564,544,20
3708110,Brogden,NC,1084,966,118
3708140,Brookford,NC,218,200,18
3708420,Brunswick,NC,157,135,22
3708480,Bryson City,NC,836,621,215
3708760,Buies Creek,NC,1170,917,253
3708860,Bunn,NC,166,151,15
3708880,Bunnlevel,NC,246,213,33
3708960,Burgaw,NC,1418,1233,185
3709060,Burlington,NC,25771,23873,1898
3709140,Burnsville,NC,870,737,133
3709360,Butner,NC,3112,2982,130
3709380,Butters,NC,131,118,13
3709400,Buxton,NC,940,548,392
3709530,Cajah's Mountain,NC,1196,1110,86
3709540,Calabash,NC,1546,992,554
3709760,Calypso,NC,184,136,48
3709780,Camden,NC,279,267,12
3709800,Cameron,NC,137,112,25
3710120,Candor,NC,322,277,45
3710240,Canton,NC,2086,1928,158
3710260,Cape Carteret,NC,1142,920,222
3710264,Cape Colony,NC,383,308,75
3710460,Caroleen,NC,265,209,56
3710500,Carolina Beach,NC,5618,3090,2528
3710532,Carolina Meadows,NC,488,458,30
3710550,Carolina Shores,NC,2767,2331,436
3710620,Carrboro,NC,9912,9363,549
3710680,Carthage,NC,1216,1021,195
3710740,Cary,NC,70171,66959,3212
3710760,Casar,NC,150,134,16
3710800,Cashiers,NC,682,309,373
3710860,Castalia,NC,129,108,21
3710880,Castle Hayne,NC,564,526,38
3710960,Caswell Beach,NC,681,209,472
3710980,Catawba,NC,307,285,22
3711340,Cedar Point,NC,1237,719,518
3711352,Cedar Rock,NC,136,131,5
3711560,Centerville,NC,85,58,27
3711560,Centerville,NC,85,58,27
3711620,Cerro Gordo,NC,69,60,9
3711640,Chadbourn,NC,845,693,152
3711800,Chapel Hill,NC,23713,22118,1595
3712000,Charlotte,NC,379904,355413,24491
3712140,Cherokee,NC,918,816,102
3712186,Cherry Branch,NC,461,443,18
3712340,Cherryville,NC,2745,2442,303
3712460,Chimney Rock Village,NC,168,71,97
3712480,China Grove,NC,1911,1772,139
3712520,Chinquapin,NC,65,40,25
3712580,Chocowinity,NC,389,336,53
3712590,Chowan Beach,NC,188,141,47
3712720,Claremont,NC,774,716,58
3712780,Clarkton,NC,297,251,46
3712860,Clayton,NC,10576,9915,661
3712960,Clemmons,NC,8897,8427,470
3713000,Cleveland,NC,374,346,28
3713100,Cliffside,NC,234,216,18
3713240,Clinton,NC,3772,3348,424
3713280,Clyde,NC,637,583,54
3713360,Coats,NC,998,889,109
3713460,Cofield,NC,157,118,39
3713500,Coinjock,NC,165,142,23
3713560,Colerain,NC,113,84,29
3713940,Columbia,NC,349,264,85
3713980,Columbus,NC,472,421,51
3714060,Como,NC,43,28,15
3714100,Concord,NC,40772,38599,2173
3714200,Conetoe,NC,118,100,18
3714280,Connelly Springs,NC,838,642,196
3714340,Conover,NC,3805,3541,264
3714400,Conway,NC,363,305,58
3714460,Cooleemee,NC,424,363,61
3714600,Cordova,NC,738,684,54
3714700,Cornelius,NC,14536,13528,1008
3715020,Cove City,NC,197,173,24
3715040,Cove Creek,NC,573,472,101
3715260,Cramerton,NC,2506,2263,243
3715320,Creedmoor,NC,1953,1815,138
3715420,Creswell,NC,122,97,25
3715440,Cricket,NC,873,762,111
3715580,Crossnore,NC,75,47,28
3715640,Crouse,NC,160,147,13
3715880,Cullowhee,NC,2366,1739,627
3716084,Cypress Landing,NC,661,616,45
3716180,Dallas,NC,2522,2328,194
3716220,Dana,NC,1463,1343,120
3716240,Danbury,NC,51,51,0
3716400,Davidson,NC,5898,5450,448
3716480,Davis,NC,240,135,105
3716720,Deep Run,NC,248,234,14
3716730,Deercroft,NC,190,175,15
3716780,Delco,NC,143,120,23
3716820,Dellview,NC,3,3,0
3716860,Delway,NC,89,64,25
3716980,Denton,NC,731,658,73
3717000,Denver,NC,1206,1137,69
3717180,Dillsboro,NC,136,115,21
3717325,Dobbins Heights,NC,378,321,57
3717340,Dobson,NC,594,558,36
3717520,Dortches,NC,477,430,47
3717660,Dover,NC,186,161,25
3717860,Drexel,NC,811,720,91
3718040,Dublin,NC,120,107,13
3718060,Duck,NC,2461,365,2096
3718080,Dudley,NC,364,295,69
3718300,Dundarrach,NC,18,15,3
3718320,Dunn,NC,4150,3728,422
3719000,Durham,NC,128005,119052,8953
3719140,Earl,NC,106,93,13
3719300,East Arcadia,NC,198,174,24
3719320,East Bend,NC,291,255,36
3719420,East Flat Rock,NC,2286,2138,148
3719620,East Laurinburg,NC,122,102,20
3719740,Eastover,NC,1658,1494,164
3719800,East Rockingham,NC,1572,1357,215
3719860,East Spencer,NC,784,653,131
3720080,Eden,NC,7740,6706,1034
3720120,Edenton,NC,2449,1942,507
3720280,Edneyville,NC,1065,923,142
3720420,Efland,NC,369,332,37
3720580,Elizabeth City,NC,8642,7499,1143
3720600,Elizabethtown,NC,1631,1434,197
3720620,Elkin,NC,2059,1766,293
3720700,Elk Park,NC,287,251,36
3720780,Ellenboro,NC,353,288,65
3720840,Ellerbe,NC,426,372,54
3720980,Elm City,NC,588,525,63
3721095,Elon,NC,3175,2851,324
3721120,Elrod,NC,158,141,17
3721130,Elroy,NC,1701,1537,164
3721160,Emerald Isle,NC,6769,1862,4907
3721260,Emma,NC,872,815,57
3721360,Enfield,NC,1034,808,226
3721380,Engelhard,NC,233,149,84
3721500,Enochville,NC,1258,1146,112
3721740,Erwin,NC,2026,1828,198
3721880,Etowah,NC,3680,3284,396
3721960,Eureka,NC,102,87,15
3722040,Everetts,NC,82,57,25
3722080,Evergreen,NC,165,140,25
3722240,Fair Bluff,NC,417,294,123
3722280,Fairfield,NC,127,84,43
3722305,Fairfield Harbour,NC,1744,1382,362
3722360,Fairmont,NC,1107,955,152
3722380,Fairplains,NC,939,835,104
3722440,Fairview,NC,1256,1142,114
3722500,Fairview,NC,1364,1300,64
3722560,Faison,NC,387,305,82
3722600,Faith,NC,354,321,33
3722620,Falcon,NC,88,87,1
3722640,Falkland,NC,29,25,4
3722720,Fallston,NC,261,236,25
3722800,Farmington,NC,140,131,9
3722820,Farmville,NC,2237,1918,319
3722920,Fayetteville,NC,90326,81739,8587
3722982,Fearrington Village,NC,1605,1493,112
3723520,Five Points,NC,373,345,28
3723600,Flat Rock,NC,2176,1686,490
3723640,Flat Rock,NC,720,604,116
3723760,Fletcher,NC,3642,3387,255
3723980,Fontana Dam,NC,70,13,57
3724080,Forest City,NC,3511,3074,437
3724170,Forest Hills,NC,194,139,55
3724198,Forest Oaks,NC,1664,1620,44
3724380,Foscoe,NC,1555,702,853
3724440,Fountain,NC,195,153,42
3724520,Four Oaks,NC,955,857,98
3724570,Foxfire,NC,648,554,94
3724640,Franklin,NC,2299,1915,384
3724720,Franklinton,NC,1169,1025,144
3724740,Franklinville,NC,468,418,50
3724900,Fremont,NC,598,458,140
3725020,Frisco,NC,1088,493,595
3725160,Fruitland,NC,1349,991,358
3725300,Fuquay-Varina,NC,13204,12246,958
3725380,Gamewell,NC,1683,1533,150
3725460,Garland,NC,287,222,65
3725480,Garner,NC,13779,12844,935
3725540,Garysburg,NC,502,403,99
3725560,Gaston,NC,482,397,85
3725580,Gastonia,NC,34346,31870,2476
3725680,Gatesville,NC,145,123,22
3725880,Germanton,NC,389,355,34
3725900,Gerton,NC,258,146,112
3725940,Gibson,NC,218,196,22
3725980,Gibsonville,NC,3653,3493,160
3726200,Glen Alpine,NC,678,606,72
3726460,Glen Raven,NC,1272,1185,87
3726520,Glenville,NC,242,80,162
3726560,Glenwood,NC,233,221,12
3726680,Gloucester,NC,315,213,102
3726740,Godwin,NC,58,58,0
3726800,Gold Hill,NC,168,146,22
3726880,Goldsboro,NC,16213,13832,2381
3726920,Goldston,NC,131,114,17
3727120,Gorman,NC,432,387,45
3727180,Governors Club,NC,971,898,73
3727182,Governors Village,NC,718,675,43
3727280,Graham,NC,7840,7199,641
3727300,Graingers,NC,129,116,13
3727324,Grandfather Village,NC,406,42,364
3727400,Grandy,NC,1386,1133,253
3727420,Granite Falls,NC,2105,1970,135
3727440,Granite Quarry,NC,1290,1197,93
3727520,Grantsboro,NC,310,257,53
3727780,Greenevers,NC,287,236,51
3727870,Green Level,NC,1217,1112,105
3728000,Greensboro,NC,131976,122250,9726
3728080,Greenville,NC,45147,38001,7146
3728200,Grifton,NC,1089,962,127
3728240,Grimesland,NC,200,151,49
3728400,Grover,NC,331,305,26
3728600,Gulf,NC,60,44,16
3728900,Half Moon,NC,3100,2825,275
3728920,Halifax,NC,114,90,24
3729000,Hallsboro,NC,219,175,44
3729120,Hamilton,NC,165,128,37
3729160,Hamlet,NC,2822,2529,293
3729180,Hampstead,NC,2898,2582,316
3729560,Harkers Island,NC,1178,547,631
3729640,Harmony,NC,219,208,11
3729680,Harrells,NC,90,77,13
3729720,Harrellsville,NC,50,43,7
3729800,Harrisburg,NC,6374,6183,191
3730040,Hassell,NC,31,24,7
3730100,Hatteras,NC,813,252,561
3730120,Havelock,NC,6545,5708,837
3730260,Haw River,NC,1096,917,179
3730280,Hayesville,NC,229,186,43
3730340,Hays,NC,732,663,69
3730620,Hemby Bridge,NC,605,591,14
3730660,Henderson,NC,6876,6148,728
3730720,Hendersonville,NC,8371,7472,899
3730800,Henrietta,NC,168,139,29
3730900,Hertford,NC,1009,819,190
3731060,Hickory,NC,20064,18273,1791
3731260,Hiddenite,NC,247,222,25
3731360,Highlands,NC,2307,573,1734
3731400,High Point,NC,47951,44382,3569
3731440,High Shoals,NC,259,237,22
3731440,High Shoals,NC,259,237,22
3731490,Hightsville,NC,171,158,13
3731500,Hildebran,NC,773,698,75
3731620,Hillsborough,NC,4267,3943,324
3731860,Hobgood,NC,158,102,56
3731880,Hobucken,NC,101,41,60
3731920,Hoffman,NC,208,169,39
3731960,Holden Beach,NC,2303,458,1845
3732100,Hollister,NC,340,269,71
3732180,Holly Ridge,NC,2205,1661,544
3732260,Holly Springs,NC,14237,13396,841
3732540,Hookerton,NC,192,171,21
3732580,Hoopers Creek,NC,493,442,51
3732640,Hope Mills,NC,7060,6643,417
3732740,Horse Shoe,NC,1035,958,77
3732840,Hot Springs,NC,315,250,65
3732980,Hudson,NC,1717,1617,100
3733120,Huntersville,NC,23962,23037,925
3733320,Icard,NC,1083,962,121
3733460,Indian Beach,NC,1689,115,1574
3733560,Indian Trail,NC,13712,13287,425
3733640,Ingold,NC,180,149,31
3733820,Iron Station,NC,341,315,26
3733940,Ivanhoe,NC,107,81,26
3733993,JAARS,NC,211,164,47
3734000,Jackson,NC,235,204,31
3734038,Jackson Heights,NC,474,422,52
3734160,Jackson Springs,NC,70,48,22
3734200,Jacksonville,NC,24004,20582,3422
3734260,James City,NC,2532,2170,362
3734300,Jamestown,NC,1739,1627,112
3734320,Jamesville,NC,227,192,35
3734440,Jefferson,NC,782,652,130
3734840,Jonesville,NC,1132,1026,106
3735200,Kannapolis,NC,21963,20313,1650
3735340,Keener,NC,226,196,30
3735360,Kelford,NC,112,76,36
3735440,Kelly,NC,256,201,55
3735460,Kenansville,NC,367,310,57
3735540,Kenly,NC,709,619,90
3735600,Kernersville,NC,12563,11827,736
3735720,Kill Devil Hills,NC,7020,3294,3726
3735760,King,NC,3159,2989,170
3735870,Kings Grant,NC,3705,3470,235
3735880,Kings Mountain,NC,4883,4490,393
3735890,Kingstown,NC,271,244,27
3735920,Kinston,NC,10476,8677,1799
3736020,Kittrell,NC,64,51,13
3736060,Kitty Hawk,NC,3207,1574,1633
3736080,Knightdale,NC,7635,7320,315
3736220,Kure Beach,NC,2121,1037,1084
3736400,La Grange,NC,1342,1133,209
3736480,Lake Junaluska,NC,2018,1456,562
3736500,Lake Lure,NC,2250,713,1537
3736510,Lake Norman of Catawba,NC,4548,3631,917
3736511,Lake Norman of Catawba,NC,4753,4146,607
3736511,Lake Norman of Iredell,NC,4753,4146,607
3736512,Lake Park,NC,1254,1220,34
3736513,Lake Royale,NC,2489,1569,920
3736514,Lake Santeetlah,NC,118,23,95
3736640,Lake Waccamaw,NC,958,553,405
3736860,Landis,NC,1639,1501,138
3736960,Lansing,NC,78,63,15
3737000,Lasker,NC,49,33,16
3737040,Lattimore,NC,146,124,22
3737120,Laurel Hill,NC,529,473,56
3737160,Laurel Park,NC,1310,1087,223
3737220,Laurinburg,NC,6805,6098,707
3737260,Lawndale,NC,282,239,43
3737640,Leggett,NC,24,22,2
3737680,Leland,NC,10905,10116,789
3737760,Lenoir,NC,8401,7600,801
3738030,Lewiston Woodville,NC,215,182,33
3738040,Lewisville,NC,5485,5234,251
3738060,Lexington,NC,8906,7832,1074
3738100,Liberty,NC,1209,1104,105
3738170,Light Oak,NC,311,282,29
3738200,Lilesville,NC,189,168,21
3738220,Lillington,NC,1504,1353,151
3738320,Lincolnton,NC,5225,4709,516
3738360,Linden,NC,64,58,6
3738420,Linville,NC,343,134,209
3738680,Littleton,NC,342,269,73
3738860,Locust,NC,1925,1837,88
3739060,Long Creek,NC,130,112,18
3739280,Long View,NC,2353,2127,226
3739360,Louisburg,NC,1283,1029,254
3739420,Love Valley,NC,192,82,110
3739480,Lowell,NC,1598,1501,97
3739520,Lowesville,NC,1321,1272,49
3739540,Lowgap,NC,140,115,25
3739600,Lucama,NC,475,381,94
3739680,Lumber Bridge,NC,37,34,3
3739700,Lumberton,NC,8531,7266,1265
3739880,McAdenville,NC,375,331,44
3739960,Macclesfield,NC,221,177,44
3740140,McDonald,NC,41,30,11
3740240,McFarlan,NC,41,28,13
3740460,McLeansville,NC,466,436,30
3740540,Macon,NC,54,42,12
3740560,Madison,NC,1131,998,133
3740600,Maggie Valley,NC,1709,774,935
3740640,Magnolia,NC,389,315,74
3740660,Maiden,NC,1493,1392,101
3740860,Mamers,NC,350,320,30
3740980,Manns Harbor,NC,472,322,150
3741060,Manteo,NC,1344,752,592
3741220,Marble,NC,152,120,32
3741380,Marietta,NC,53,53,0
3741420,Marion,NC,3142,2813,329
3741540,Mar-Mac,NC,1506,1305,201
3741580,Marshall,NC,462,406,56
3741600,Marshallberg,NC,277,154,123
3741620,Mars Hill,NC,725,617,108
3741640,Marshville,NC,952,866,86
3741720,Marvin,NC,1888,1843,45
3741960,Matthews,NC,12156,11663,493
3742000,Maury,NC,199,177,22
3742020,Maxton,NC,1061,858,203
3742060,Mayodan,NC,1330,1180,150
3742100,Maysville,NC,462,364,98
3742240,Mebane,NC,7736,7308,428
3742480,Mesic,NC,92,66,26
3742620,Micro,NC,212,197,15
3742640,Middleburg,NC,43,39,4
3742700,Middlesex,NC,468,423,45
3742760,Midland,NC,1745,1694,51
3742860,Midway,NC,2022,1945,77
3743160,Millers Creek,NC,915,833,82
3743200,Millingport,NC,252,222,30
3743260,Mills River,NC,3177,2886,291
3743300,Milton,NC,97,74,23
3743320,Milwaukee,NC,95,75,20
3743360,Mineral Springs,NC,1166,1135,31
3743440,Minnesott Beach,NC,365,263,102
3743480,Mint Hill,NC,10302,9824,478
3743580,Misenheimer,NC,125,104,21
3743720,Mocksville,NC,2529,2344,185
3743860,Momeyer,NC,140,127,13
3743880,Moncure,NC,347,307,40
3743920,Monroe,NC,12924,12160,764
3744100,Montreat,NC,618,230,388
3744160,Mooresboro,NC,135,126,9
3744220,Mooresville,NC,20842,19441,1401
3744280,Moravian Falls,NC,835,707,128
3744320,Morehead City,NC,5940,4665,1275
3744400,Morganton,NC,7559,6862,697
3744520,Morrisville,NC,11757,11104,653
3744560,Morven,NC,171,139,32
3744700,Mountain Home,NC,1538,1389,149
3744770,Mountain View,NC,1455,1416,39
3744800,Mount Airy,NC,5378,4865,513
3744900,Mount Gilead,NC,501,455,46
3744960,Mount Holly,NC,7687,7197,490
3745100,Mount Olive,NC,1969,1624,345
3745140,Mount Pleasant,NC,692,616,76
3745460,Moyock,NC,1775,1717,58
3745560,Mulberry,NC,1058,966,92
3745640,Murfreesboro,NC,1069,938,131
3745660,Murphy,NC,825,692,133
3745720,Murraysville,NC,7303,6761,542
3745840,Myrtle Grove,NC,4743,4449,294
3745880,Nags Head,NC,5130,1409,3721
3746000,Nashville,NC,2625,2386,239
3746060,Navassa,NC,619,560,59
3746100,Nebo,NC,833,744,89
3746280,Neuse Forest,NC,885,831,54
3746340,New Bern,NC,15655,13798,1857
3746650,New Hope,NC,706,652,54
3746740,Newland,NC,380,309,71
3746820,New London,NC,258,243,15
3746860,Newport,NC,1918,1718,200
3747000,Newton,NC,5776,5294,482
3747020,Newton Grove,NC,263,251,12
3747240,Norlina,NC,489,416,73
3747260,Norman,NC,53,42,11
3747485,Northchase,NC,1696,1613,83
3747695,Northlakes,NC,649,613,36
3747845,North Topsail Beach,NC,2675,545,2130
3747860,Northwest,NC,318,298,20
3747880,North Wilkesboro,NC,1941,1718,223
3747980,Norwood,NC,1297,976,321
3748040,Oakboro,NC,884,836,48
3748060,Oak City,NC,177,126,51
3748345,Oak Island,NC,9910,4237,5673
3748480,Oak Ridge,NC,2637,2544,93
3748700,Ocean Isle Beach,NC,3045,454,2591
3748740,Ocracoke,NC,966,390,576
3748790,Ogden,NC,3313,3160,153
3748920,Old Fort,NC,469,376,93
3748940,Old Hundred,NC,92,72,20
3749380,Oriental,NC,689,468,221
3749460,Orrum,NC,36,28,8
3749600,Ossipee,NC,255,231,24
3749800,Oxford,NC,3889,3537,352
3750080,Pantego,NC,83,67,16
3750340,Parkton,NC,228,195,33
3750540,Parmele,NC,124,95,29
3750700,Patterson Springs,NC,257,230,27
3750820,Peachland,NC,187,158,29
3751040,Peletier,NC,501,369,132
3751080,Pembroke,NC,1263,1174,89
3751780,Pikeville,NC,332,274,58
3751820,Pilot Mountain,NC,734,681,53
3751840,Pinebluff,NC,639,606,33
3751940,Pinehurst,NC,9363,7894,1469
3752000,Pine Knoll Shores,NC,2057,669,1388
3752020,Pine Level,NC,861,818,43
3752140,Pinetops,NC,610,523,87
3752160,Pinetown,NC,71,61,10
3752220,Pineville,NC,5201,4826,375
3752260,Piney Green,NC,6127,5339,788
3752400,Pink Hill,NC,215,192,23
3752500,Pinnacle,NC,368,320,48
3752660,Pittsboro,NC,1901,1791,110
3752685,Plain View,NC,795,753,42
3752760,Pleasant Garden,NC,2051,1924,127
3752920,Pleasant Hill,NC,427,367,60
3753040,Plymouth,NC,1755,1420,335
3753140,Polkton,NC,390,354,36
3753160,Polkville,NC,256,219,37
3753200,Pollocksville,NC,163,124,39
3753475,Porters Neck,NC,3403,3164,239
3753580,Potters Hill,NC,212,174,38
3753680,Powellsville,NC,117,94,23
3753820,Princeton,NC,611,550,61
3753840,Princeville,NC,631,515,116
3753900,Proctorville,NC,50,46,4
3753950,Prospect,NC,350,332,18
3754160,Pumpkin Center,NC,790,719,71
3754580,Raeford,NC,1946,1788,158
3754600,Raemon,NC,84,79,5
3755000,Raleigh,NC,208114,195659,12455
3755040,Ramseur,NC,728,647,81
3755080,Randleman,NC,1982,1871,111
3755260,Ranlo,NC,1720,1634,86
3755340,Raynham,NC,27,27,0
3755460,Red Cross,NC,344,320,24
3755640,Red Oak,NC,1373,1316,57
3755660,Red Springs,NC,1520,1309,211
3755900,Reidsville,NC,7280,6423,857
3755940,Rennert,NC,115,88,27
3756100,Rex,NC,20,20,0
3756240,Rhodhiss,NC,427,378,49
3756340,Richfield,NC,260,231,29
3756360,Richlands,NC,892,793,99
3756440,Rich Square,NC,414,337,77
3756600,Riegelwood,NC,252,220,32
3756710,River Bend,NC,1596,1379,217
3756815,River Road,NC,2026,1727,299
3756900,Roanoke Rapids,NC,7248,6569,679
3757000,Robbins,NC,465,396,69
3757020,Robbinsville,NC,322,237,85
3757039,Roberdel,NC,120,105,15
3757100,Robersonville,NC,692,555,137
3757200,Rockfish,NC,1306,1244,62
3757260,Rockingham,NC,4357,3919,438
3757340,Rockwell,NC,951,880,71
3757500,Rocky Mount,NC,26168,23095,3073
3757540,Rocky Point,NC,579,498,81
3757580,Rodanthe,NC,530,100,430
3757640,Rolesville,NC,3086,2978,108
3757700,Ronda,NC,194,168,26
3757740,Roper,NC,263,195,68
3757800,Roseboro,NC,575,475,100
3757860,Rose Hill,NC,654,540,114
3758020,Rosman,NC,283,261,22
3758040,Rougemont,NC,454,421,33
3758140,Rowland,NC,465,384,81
3758160,Roxboro,NC,3937,3509,428
3758180,Roxobel,NC,105,87,18
3758260,Royal Pines,NC,1900,1757,143
3758340,Ruffin,NC,160,140,20
3758360,Rural Hall,NC,1556,1436,120
3758420,Ruth,NC,163,141,22
3758440,Rutherford College,NC,582,526,56
3758460,Rutherfordton,NC,1816,1586,230
3758620,St. Helena,NC,171,152,19
3758630,St. James,NC,4163,3368,795
3758720,St. Pauls,NC,955,850,105
3758730,St. Stephens,NC,3731,3466,265
3758740,Salem,NC,1045,981,64
3758840,Salemburg,NC,223,201,22
3758860,Salisbury,NC,15095,13626,1469
3758920,Saluda,NC,474,280,194
3758940,Salvo,NC,629,131,498
3759090,Sandy Creek,NC,104,93,11
3759135,Sandyfield,NC,176,163,13
3759280,Sanford,NC,12428,11447,981
3759340,Saratoga,NC,191,156,35
3759540,Sawmills,NC,2226,2072,154
3759580,Saxapahaw,NC,795,724,71
3759765,Scotch Meadows,NC,204,198,6
3759780,Scotland Neck,NC,928,757,171
3759980,Seaboard,NC,328,259,69
3760000,Sea Breeze,NC,1113,986,127
3760080,Seagrove,NC,120,98,22
3760180,Sedalia,NC,303,280,23
3760320,Selma,NC,2643,2359,284
3760505,Seven Devils,NC,573,149,424
3760515,Seven Lakes,NC,2658,2072,586
3760540,Seven Springs,NC,37,22,15
3760560,Severn,NC,108,88,20
3760800,Shallotte,NC,1946,1814,132
3760940,Shannon,NC,76,70,6
3761060,Sharpsburg,NC,858,760,98
3761200,Shelby,NC,10089,9177,912
3761860,Siler City,NC,2918,2696,222
3761920,Silver City,NC,376,281,95
3761950,Silver Lake,NC,2692,2562,130
3762040,Simpson,NC,196,179,17
3762060,Sims,NC,129,110,19
3762190,Skippers Corner,NC,1249,1109,140
3762520,Smithfield,NC,4940,4481,459
3762580,Smithtown,NC,100,80,20
3762680,Sneads Ferry,NC,1680,1166,514
3762760,Snow Hill,NC,775,667,108
3763120,Southern Pines,NC,8364,7322,1042
3763130,Southern Shores,NC,2506,1355,1151
3763240,South Henderson,NC,458,394,64
3763340,South Mills,NC,179,161,18
3763360,Southmont,NC,802,659,143
3763400,Southport,NC,2332,1985,347
3763470,South Rosemary,NC,1356,1200,156
3763560,South Weldon,NC,264,202,62
3763680,Sparta,NC,920,754,166
3763720,Speed,NC,33,27,6
3763760,Spencer,NC,1473,1277,196
3763780,Spencer Mountain,NC,0,0,0
3763880,Spindale,NC,1957,1722,235
3763920,Spivey's Corner,NC,209,199,10
3764000,Spout Springs,NC,3819,3533,286
3764050,Springdale,NC,546,514,32
3764160,Spring Hope,NC,719,625,94
3764180,Spring Lake,NC,5359,4541,818
3764260,Spruce Pine,NC,1064,920,144
3764380,Staley,NC,168,157,11
3764420,Stallings,NC,6122,5968,154
3764460,Stanfield,NC,611,593,18
3764500,Stanley,NC,1687,1555,132
3764560,Stantonsburg,NC,377,325,52
3764580,Star,NC,355,298,57
3764740,Statesville,NC,12435,11424,1011
3764840,Stedman,NC,531,497,34
3764940,Stem,NC,389,364,25
3765020,Stokes,NC,175,160,15
3765040,Stokesdale,NC,2244,2121,123
3765100,Stoneville,NC,614,560,54
3765120,Stonewall,NC,115,99,16
3765260,Stony Point,NC,558,501,57
3765320,Stovall,NC,166,148,18
3765530,Sugar Mountain,NC,1563,198,1365
3765580,Summerfield,NC,4014,3836,178
3765700,Sunbury,NC,147,121,26
3765900,Sunset Beach,NC,5066,2276,2790
3766040,Surf City,NC,4145,1531,2614
3766280,Swannanoa,NC,2065,1894,171
3766340,Swan Quarter,NC,182,129,53
3766360,Swansboro,NC,1821,1558,263
3766460,Swepsonville,NC,975,918,57
3766500,Sylva,NC,1213,1032,181
3766520,Tabor City,NC,1232,1084,148
3766700,Tarboro,NC,5058,4545,513
3766740,Tar Heel,NC,53,47,6
3766960,Taylorsville,NC,1110,1005,105
3766980,Taylortown,NC,313,264,49
3767000,Teachey,NC,197,184,13
3767420,Thomasville,NC,11883,10890,993
3767700,Toast,NC,691,614,77
3767720,Tobaccoville,NC,1157,1081,76
3768040,Topsail Beach,NC,1359,240,1119
3768320,Trenton,NC,114,87,27
3768340,Trent Woods,NC,1843,1741,102
3768400,Trinity,NC,3032,2856,176
3768500,Troutman,NC,1460,1378,82
3768520,Troy,NC,1204,1061,143
3768580,Tryon,NC,960,798,162
3768740,Turkey,NC,94,90,4
3769020,Tyro,NC,1586,1458,128
3769260,Unionville,NC,2508,2381,127
3769520,Valdese,NC,2135,1950,185
3769600,Valle Crucis,NC,315,193,122
3769640,Valley Hill,NC,1185,992,193
3769680,Vanceboro,NC,426,377,49
3769720,Vandemere,NC,136,93,43
3769740,Vander,NC,620,558,62
3769755,Vann Crossroads,NC,134,118,16
3769795,Varnamtown,NC,274,241,33
3769840,Vass,NC,411,378,33
3770320,Waco,NC,133,122,11
3770340,Wade,NC,310,251,59
3770380,Wadesboro,NC,2368,2002,366
3770480,Wagram,NC,320,271,49
3770540,Wake Forest,NC,17828,16869,959
3770580,Wakulla,NC,49,49,0
3770660,Walkertown,NC,2598,2413,185
3770720,Wallace,NC,1597,1328,269
3770740,Wallburg,NC,1245,1181,64
3770780,Walnut Cove,NC,769,702,67
3770820,Walnut Creek,NC,451,410,41
3770860,Walstonburg,NC,107,87,20
3770920,Wanchese,NC,704,630,74
3771100,Warrenton,NC,528,419,109
3771160,Warsaw,NC,1394,1095,299
3771220,Washington,NC,5023,4351,672
3771240,Washington Park,NC,216,186,30
3771320,Watha,NC,86,77,9
3771440,Waves,NC,362,81,281
3771460,Waxhaw,NC,6410,6222,188
3771500,Waynesville,NC,5525,4689,836
3771560,Weaverville,NC,2354,2140,214
3771600,Webster,NC,184,156,28
3771680,Weddington,NC,4297,4159,138
3771760,Welcome,NC,1810,1681,129
3771780,Weldon,NC,732,587,145
3771860,Wendell,NC,3868,3644,224
3771900,Wentworth,NC,1113,1009,104
3771940,Wesley Chapel,NC,2887,2796,91
3772150,West Canton,NC,586,532,54
3772540,West Jefferson,NC,721,593,128
3772600,West Marion,NC,568,526,42
3772755,Westport,NC,2293,2138,155
3773140,Whispering Pines,NC,1858,1765,93
3773160,Whitakers,NC,354,294,60
3773300,White Lake,NC,1146,419,727
3773320,White Oak,NC,147,128,19
3773460,White Plains,NC,492,457,35
3773660,Whiteville,NC,2425,2130,295
3773760,Whitsett,NC,271,253,18
3773780,Whittier,NC,16,6,10
3774020,Wilkesboro,NC,1685,1528,157
3774220,Williamston,NC,2671,2271,400
3774440,Wilmington,NC,59484,52731,6753
3774540,Wilson,NC,22504,19951,2553
3774580,Wilson's Mills,NC,958,915,43
3774680,Windsor,NC,1157,977,180
3774720,Winfall,NC,272,226,46
3774760,Wingate,NC,1013,915,98
3775000,Winston-Salem,NC,112140,102171,9969
3775060,Winterville,NC,4166,3940,226
3775080,Winton,NC,336,271,65
3775280,Woodfin,NC,3689,3246,443
3775340,Woodland,NC,320,251,69
3775375,Woodlawn,NC,382,366,16
3775780,Wrightsboro,NC,2348,2218,130
3775820,Wrightsville Beach,NC,2819,1180,1639
3775880,Yadkin College,NC,183,152,31
3775960,Yadkinville,NC,1203,1070,133
3776000,Yanceyville,NC,744,641,103
3776200,Youngsville,NC,903,876,27
3776220,Zebulon,NC,2682,2508,174
