geocode,county,state,hs_total,hs_occupied,hs_vacant
37001020100,Alamance,NC,2059,1894,165
37001020200,Alamance,NC,1786,1607,179
37001020301,Alamance,NC,1677,1571,106
37001020302,Alamance,NC,1435,1360,75
37001020400,Alamance,NC,2710,2464,246
37001020501,Alamance,NC,1686,1488,198
37001020502,Alamance,NC,1592,1474,118
37001020601,Alamance,NC,1435,1347,88
37001020602,Alamance,NC,1289,1212,77
37001020701,Alamance,NC,2554,2379,175
37001020702,Alamance,NC,2486,2323,163
37001020801,Alamance,NC,880,803,77
37001020802,Alamance,NC,2676,2446,230
37001020901,Alamance,NC,1636,1521,115
37001020902,Alamance,NC,1662,1551,111
37001021000,Alamance,NC,1944,1763,181
37001021101,Alamance,NC,1993,1771,222
37001021102,Alamance,NC,1566,1477,89
37001021201,Alamance,NC,2756,2434,322
37001021204,Alamance,NC,2120,1991,129
37001021205,Alamance,NC,3547,3334,213
37001021206,Alamance,NC,2217,2096,121
37001021207,Alamance,NC,1635,1541,94
37001021300,Alamance,NC,2581,2403,178
37001021400,Alamance,NC,1232,1147,85
37001021500,Alamance,NC,1945,1817,128
37001021600,Alamance,NC,2701,2524,177
37001021701,Alamance,NC,1621,1497,124
37001021702,Alamance,NC,1793,1662,131
37001021703,Alamance,NC,3757,3522,235
37001021801,Alamance,NC,2035,1880,155
37001021802,Alamance,NC,1540,1447,93
37001021803,Alamance,NC,1312,1191,121
37001021901,Alamance,NC,2011,1872,139
37001021902,Alamance,NC,1907,1761,146
37001022001,Alamance,NC,1622,1510,112
37001022002,Alamance,NC,1987,1845,142
37003040100,Alexander,NC,1474,1297,177
37003040200,Alexander,NC,1792,1627,165
37003040300,Alexander,NC,1399,1267,132
37003040400,Alexander,NC,2977,2694,283
37003040500,Alexander,NC,2916,2627,289
37003040600,Alexander,NC,2339,2059,280
37003040700,Alexander,NC,3063,2837,226
37005950100,Alleghany,NC,3210,1804,1406
37005950200,Alleghany,NC,1995,1603,392
37005950300,Alleghany,NC,2461,1437,1024
37007920100,Anson,NC,1346,1188,158
37007920200,Anson,NC,676,590,86
37007920301,Anson,NC,2106,1868,238
37007920302,Anson,NC,306,273,33
37007920400,Anson,NC,1201,1005,196
37007920501,Anson,NC,462,402,60
37007920502,Anson,NC,2072,1800,272
37007920600,Anson,NC,1665,1428,237
37007980000,Anson,NC,0,0,0
37009970200,Ashe,NC,1565,1139,426
37009970300,Ashe,NC,1518,1067,451
37009970400,Ashe,NC,2496,1964,532
37009970501,Ashe,NC,2083,1494,589
37009970502,Ashe,NC,1606,1291,315
37009970701,Ashe,NC,2603,1496,1107
37009970702,Ashe,NC,1691,1088,603
37009970801,Ashe,NC,1493,976,517
37009970802,Ashe,NC,1880,1193,687
37011930100,Avery,NC,2797,1194,1603
37011930200,Avery,NC,5361,1605,3756
37011930301,Avery,NC,2304,1467,837
37011930302,Avery,NC,1600,1266,334
37011930400,Avery,NC,1765,1328,437
37013930101,Beaufort,NC,1490,1175,315
37013930102,Beaufort,NC,1090,841,249
37013930200,Beaufort,NC,2695,2449,246
37013930300,Beaufort,NC,2219,1858,361
37013930400,Beaufort,NC,2410,2133,277
37013930501,Beaufort,NC,2242,1913,329
37013930502,Beaufort,NC,1571,1426,145
37013930600,Beaufort,NC,1566,1357,209
37013930700,Beaufort,NC,2123,1253,870
37013930800,Beaufort,NC,1319,905,414
37013930900,Beaufort,NC,2598,1859,739
37013931001,Beaufort,NC,1239,1041,198
37013931002,Beaufort,NC,1528,1220,308
37015960100,Bertie,NC,2568,2103,465
37015960200,Bertie,NC,1706,1387,319
37015960300,Bertie,NC,1487,1235,252
37015960401,Bertie,NC,1664,1348,316
37015960402,Bertie,NC,1511,1191,320
37017950101,Bladen,NC,1074,856,218
37017950102,Bladen,NC,2152,1164,988
37017950200,Bladen,NC,1279,1109,170
37017950301,Bladen,NC,1118,987,131
37017950302,Bladen,NC,1505,1349,156
37017950401,Bladen,NC,1732,1511,221
37017950402,Bladen,NC,909,822,87
37017950501,Bladen,NC,1092,956,136
37017950502,Bladen,NC,1686,1453,233
37017950601,Bladen,NC,1410,1205,205
37017950602,Bladen,NC,1174,998,176
37019020101,Brunswick,NC,1113,1018,95
37019020102,Brunswick,NC,2665,2523,142
37019020105,Brunswick,NC,3033,2819,214
37019020106,Brunswick,NC,1195,1136,59
37019020107,Brunswick,NC,1234,1122,112
37019020108,Brunswick,NC,1500,1357,143
37019020201,Brunswick,NC,2428,2224,204
37019020203,Brunswick,NC,1068,971,97
37019020204,Brunswick,NC,2946,2705,241
37019020205,Brunswick,NC,4005,3730,275
37019020206,Brunswick,NC,904,810,94
37019020304,Brunswick,NC,5547,4440,1107
37019020305,Brunswick,NC,2183,1738,445
37019020306,Brunswick,NC,1345,1181,164
37019020307,Brunswick,NC,1050,142,908
37019020308,Brunswick,NC,2456,1018,1438
37019020311,Brunswick,NC,1743,1174,569
37019020312,Brunswick,NC,532,459,73
37019020313,Brunswick,NC,2742,1424,1318
37019020314,Brunswick,NC,1061,272,789
37019020315,Brunswick,NC,2881,956,1925
37019020316,Brunswick,NC,817,333,484
37019020404,Brunswick,NC,2132,1340,792
37019020405,Brunswick,NC,1808,1366,442
37019020406,Brunswick,NC,2303,458,1845
37019020407,Brunswick,NC,1989,920,1069
37019020408,Brunswick,NC,1924,1211,713
37019020409,Brunswick,NC,2036,1092,944
37019020504,Brunswick,NC,1352,1050,302
37019020505,Brunswick,NC,1708,1539,169
37019020508,Brunswick,NC,2103,1566,537
37019020510,Brunswick,NC,2331,1201,1130
37019020511,Brunswick,NC,1885,1262,623
37019020512,Brunswick,NC,4256,610,3646
37019020513,Brunswick,NC,793,600,193
37019020514,Brunswick,NC,1471,1310,161
37019020515,Brunswick,NC,2271,1808,463
37019020516,Brunswick,NC,2925,2392,533
37019020517,Brunswick,NC,1945,1229,716
37019020518,Brunswick,NC,2740,1678,1062
37019020601,Brunswick,NC,2133,1889,244
37019020602,Brunswick,NC,2406,2210,196
37019020603,Brunswick,NC,1371,1213,158
37019990100,Brunswick,NC,0,0,0
37021000100,Buncombe,NC,1251,893,358
37021000200,Buncombe,NC,959,868,91
37021000300,Buncombe,NC,1078,997,81
37021000400,Buncombe,NC,1593,1439,154
37021000500,Buncombe,NC,2037,1797,240
37021000600,Buncombe,NC,1294,1106,188
37021000700,Buncombe,NC,1002,889,113
37021000800,Buncombe,NC,1752,1577,175
37021000900,Buncombe,NC,1715,1540,175
37021001000,Buncombe,NC,2184,2013,171
37021001100,Buncombe,NC,2429,2273,156
37021001200,Buncombe,NC,2517,2332,185
37021001300,Buncombe,NC,2036,1920,116
37021001401,Buncombe,NC,2162,2047,115
37021001402,Buncombe,NC,1018,959,59
37021001500,Buncombe,NC,1226,1114,112
37021001601,Buncombe,NC,1608,1498,110
37021001602,Buncombe,NC,1837,1605,232
37021001700,Buncombe,NC,1533,1318,215
37021001801,Buncombe,NC,2119,1908,211
37021001802,Buncombe,NC,2316,2168,148
37021001900,Buncombe,NC,2019,1881,138
37021002000,Buncombe,NC,3583,3333,250
37021002101,Buncombe,NC,672,571,101
37021002102,Buncombe,NC,2648,2394,254
37021002203,Buncombe,NC,2951,2717,234
37021002204,Buncombe,NC,5469,4902,567
37021002205,Buncombe,NC,3085,2879,206
37021002206,Buncombe,NC,2718,2409,309
37021002303,Buncombe,NC,3403,3034,369
37021002304,Buncombe,NC,796,645,151
37021002305,Buncombe,NC,2832,2574,258
37021002306,Buncombe,NC,1993,1841,152
37021002401,Buncombe,NC,1689,1484,205
37021002402,Buncombe,NC,2687,2373,314
37021002503,Buncombe,NC,1867,1726,141
37021002504,Buncombe,NC,2206,2031,175
37021002505,Buncombe,NC,2206,2094,112
37021002506,Buncombe,NC,1777,1636,141
37021002603,Buncombe,NC,1717,1518,199
37021002604,Buncombe,NC,2932,2688,244
37021002606,Buncombe,NC,1747,1622,125
37021002607,Buncombe,NC,1988,1834,154
37021002608,Buncombe,NC,2374,2206,168
37021002609,Buncombe,NC,534,509,25
37021002701,Buncombe,NC,1800,1631,169
37021002702,Buncombe,NC,2306,2107,199
37021002704,Buncombe,NC,2360,2150,210
37021002705,Buncombe,NC,701,627,74
37021002803,Buncombe,NC,1845,1729,116
37021002804,Buncombe,NC,2290,2107,183
37021002900,Buncombe,NC,1849,1606,243
37021003002,Buncombe,NC,3350,3026,324
37021003003,Buncombe,NC,2730,2475,255
37021003004,Buncombe,NC,1212,1054,158
37021003103,Buncombe,NC,1014,828,186
37021003105,Buncombe,NC,2192,1743,449
37021003106,Buncombe,NC,1122,760,362
37021003107,Buncombe,NC,2152,1908,244
37021003108,Buncombe,NC,976,856,120
37021003201,Buncombe,NC,892,802,90
37021003202,Buncombe,NC,2030,1878,152
37021003203,Buncombe,NC,2863,2587,276
37021003204,Buncombe,NC,2770,2444,326
37021003205,Buncombe,NC,1128,757,371
37023020100,Burke,NC,1880,1658,222
37023020202,Burke,NC,1885,1761,124
37023020203,Burke,NC,1920,1209,711
37023020204,Burke,NC,1318,1189,129
37023020301,Burke,NC,2102,1890,212
37023020303,Burke,NC,1986,1874,112
37023020304,Burke,NC,1174,1076,98
37023020500,Burke,NC,1358,1237,121
37023020600,Burke,NC,2834,2553,281
37023020801,Burke,NC,2375,2136,239
37023020802,Burke,NC,1439,1320,119
37023020901,Burke,NC,1572,1448,124
37023020902,Burke,NC,1676,1505,171
37023021000,Burke,NC,2437,2059,378
37023021100,Burke,NC,2610,2372,238
37023021201,Burke,NC,1723,1541,182
37023021202,Burke,NC,1743,1564,179
37023021203,Burke,NC,1744,1605,139
37023021301,Burke,NC,1945,1786,159
37023021302,Burke,NC,1644,1412,232
37023021400,Burke,NC,2160,1945,215
37025040501,Cabarrus,NC,3195,3036,159
37025040502,Cabarrus,NC,2153,2055,98
37025040600,Cabarrus,NC,2562,2413,149
37025040701,Cabarrus,NC,810,740,70
37025040703,Cabarrus,NC,1269,1198,71
37025040704,Cabarrus,NC,1469,1382,87
37025040705,Cabarrus,NC,1396,1311,85
37025040800,Cabarrus,NC,1910,1716,194
37025040900,Cabarrus,NC,1079,921,158
37025041001,Cabarrus,NC,1475,1362,113
37025041002,Cabarrus,NC,1275,1146,129
37025041100,Cabarrus,NC,2823,2672,151
37025041201,Cabarrus,NC,1476,1381,95
37025041202,Cabarrus,NC,2730,2542,188
37025041301,Cabarrus,NC,2536,2447,89
37025041304,Cabarrus,NC,2600,2564,36
37025041305,Cabarrus,NC,933,909,24
37025041306,Cabarrus,NC,2563,2446,117
37025041307,Cabarrus,NC,2342,2285,57
37025041503,Cabarrus,NC,2031,1973,58
37025041504,Cabarrus,NC,1469,1436,33
37025041505,Cabarrus,NC,2550,2504,46
37025041506,Cabarrus,NC,1871,1821,50
37025041507,Cabarrus,NC,1514,1444,70
37025041602,Cabarrus,NC,1409,1322,87
37025041603,Cabarrus,NC,1889,1818,71
37025041604,Cabarrus,NC,1667,1571,96
37025041701,Cabarrus,NC,1739,1634,105
37025041702,Cabarrus,NC,1428,1309,119
37025041901,Cabarrus,NC,810,742,68
37025041902,Cabarrus,NC,1741,1557,184
37025042000,Cabarrus,NC,2229,2077,152
37025042101,Cabarrus,NC,1449,1267,182
37025042102,Cabarrus,NC,1402,1346,56
37025042201,Cabarrus,NC,1239,1177,62
37025042202,Cabarrus,NC,1750,1656,94
37025042300,Cabarrus,NC,2284,2138,146
37025042401,Cabarrus,NC,1633,1534,99
37025042402,Cabarrus,NC,2615,2501,114
37025042501,Cabarrus,NC,2026,1921,105
37025042502,Cabarrus,NC,1221,1144,77
37025042503,Cabarrus,NC,2497,2340,157
37025042504,Cabarrus,NC,538,523,15
37025042601,Cabarrus,NC,2244,2115,129
37025042602,Cabarrus,NC,1799,1729,70
37025042603,Cabarrus,NC,3668,3475,193
37025042604,Cabarrus,NC,2102,1996,106
37027030100,Caldwell,NC,2644,2299,345
37027030200,Caldwell,NC,2411,2138,273
37027030300,Caldwell,NC,1706,1543,163
37027030400,Caldwell,NC,1984,1833,151
37027030500,Caldwell,NC,2140,1996,144
37027030600,Caldwell,NC,1902,1809,93
37027030700,Caldwell,NC,3087,2850,237
37027030801,Caldwell,NC,1560,1473,87
37027030802,Caldwell,NC,1683,1568,115
37027030900,Caldwell,NC,2437,2003,434
37027031000,Caldwell,NC,1864,1264,600
37027031100,Caldwell,NC,2058,1804,254
37027031201,Caldwell,NC,2037,1857,180
37027031202,Caldwell,NC,1882,1740,142
37027031301,Caldwell,NC,1797,1696,101
37027031302,Caldwell,NC,1815,1653,162
37027031401,Caldwell,NC,1400,1298,102
37027031402,Caldwell,NC,1525,1398,127
37027031403,Caldwell,NC,999,944,55
37029950101,Camden,NC,2255,2137,118
37029950102,Camden,NC,1864,1738,126
37031970101,Carteret,NC,656,387,269
37031970102,Carteret,NC,1550,1043,507
37031970103,Carteret,NC,1731,1186,545
37031970200,Carteret,NC,1178,547,631
37031970301,Carteret,NC,2426,2096,330
37031970304,Carteret,NC,1635,1137,498
37031970305,Carteret,NC,1285,801,484
37031970401,Carteret,NC,1177,1060,117
37031970402,Carteret,NC,927,708,219
37031970403,Carteret,NC,987,548,439
37031970501,Carteret,NC,1363,1233,130
37031970502,Carteret,NC,1019,908,111
37031970503,Carteret,NC,1034,944,90
37031970504,Carteret,NC,867,751,116
37031970601,Carteret,NC,875,476,399
37031970602,Carteret,NC,625,490,135
37031970603,Carteret,NC,723,642,81
37031970606,Carteret,NC,2026,1663,363
37031970701,Carteret,NC,549,468,81
37031970702,Carteret,NC,1789,1527,262
37031970703,Carteret,NC,2210,1979,231
37031970704,Carteret,NC,1106,930,176
37031970801,Carteret,NC,1573,1232,341
37031970804,Carteret,NC,2642,1510,1132
37031970805,Carteret,NC,801,679,122
37031970806,Carteret,NC,2501,1633,868
37031970903,Carteret,NC,2929,556,2373
37031970904,Carteret,NC,3882,1310,2572
37031971003,Carteret,NC,3933,858,3075
37031971103,Carteret,NC,4847,810,4037
37031980100,Carteret,NC,0,0,0
37031990100,Carteret,NC,0,0,0
37031990200,Carteret,NC,0,0,0
37033930100,Caswell,NC,1217,982,235
37033930200,Caswell,NC,2138,1879,259
37033930300,Caswell,NC,1876,1640,236
37033930400,Caswell,NC,1181,1066,115
37033930500,Caswell,NC,1673,1512,161
37033930600,Caswell,NC,2359,2045,314
37035010101,Catawba,NC,2615,2358,257
37035010102,Catawba,NC,2025,1896,129
37035010201,Catawba,NC,2012,1827,185
37035010203,Catawba,NC,1308,1234,74
37035010204,Catawba,NC,2150,1991,159
37035010301,Catawba,NC,2016,1901,115
37035010302,Catawba,NC,2719,2554,165
37035010303,Catawba,NC,1787,1669,118
37035010304,Catawba,NC,1699,1574,125
37035010402,Catawba,NC,2207,1972,235
37035010403,Catawba,NC,2850,2626,224
37035010404,Catawba,NC,1426,1239,187
37035010501,Catawba,NC,1880,1737,143
37035010502,Catawba,NC,1515,1407,108
37035010600,Catawba,NC,3106,2861,245
37035010700,Catawba,NC,1255,1115,140
37035010900,Catawba,NC,1708,1467,241
37035011000,Catawba,NC,1005,895,110
37035011101,Catawba,NC,1557,1460,97
37035011102,Catawba,NC,3304,2986,318
37035011200,Catawba,NC,2696,2443,253
37035011300,Catawba,NC,3118,2886,232
37035011401,Catawba,NC,1531,1416,115
37035011402,Catawba,NC,1665,1527,138
37035011501,Catawba,NC,2377,2047,330
37035011503,Catawba,NC,1811,1557,254
37035011505,Catawba,NC,2032,1560,472
37035011506,Catawba,NC,1497,1284,213
37035011601,Catawba,NC,1662,1551,111
37035011602,Catawba,NC,2367,2187,180
37035011701,Catawba,NC,1833,1737,96
37035011702,Catawba,NC,2968,2803,165
37035011801,Catawba,NC,2458,2346,112
37035011802,Catawba,NC,2585,2358,227
37037020103,Chatham,NC,2327,2158,169
37037020104,Chatham,NC,2937,2755,182
37037020105,Chatham,NC,3303,3131,172
37037020107,Chatham,NC,1151,1064,87
37037020108,Chatham,NC,810,763,47
37037020201,Chatham,NC,1368,1244,124
37037020202,Chatham,NC,1473,1351,122
37037020203,Chatham,NC,1089,981,108
37037020300,Chatham,NC,1251,1124,127
37037020401,Chatham,NC,2213,2042,171
37037020402,Chatham,NC,1790,1652,138
37037020500,Chatham,NC,1685,1465,220
37037020600,Chatham,NC,2457,2151,306
37037020702,Chatham,NC,1957,1764,193
37037020703,Chatham,NC,2357,2249,108
37037020704,Chatham,NC,1446,1352,94
37037020801,Chatham,NC,2124,1990,134
37037020802,Chatham,NC,1285,1204,81
37037020803,Chatham,NC,924,848,76
37039930101,Cherokee,NC,1200,945,255
37039930102,Cherokee,NC,1198,889,309
37039930200,Cherokee,NC,1216,946,270
37039930300,Cherokee,NC,1786,1040,746
37039930401,Cherokee,NC,2167,1697,470
37039930402,Cherokee,NC,1169,960,209
37039930501,Cherokee,NC,1217,889,328
37039930502,Cherokee,NC,2221,1629,592
37039930603,Cherokee,NC,1587,864,723
37039930604,Cherokee,NC,1068,807,261
37039930605,Cherokee,NC,1304,920,384
37039930606,Cherokee,NC,1730,1119,611
37041930101,Chowan,NC,2654,2145,509
37041930102,Chowan,NC,1160,980,180
37041930201,Chowan,NC,2300,1849,451
37041930202,Chowan,NC,1017,910,107
37043950101,Clay,NC,2198,1307,891
37043950102,Clay,NC,1752,1208,544
37043950201,Clay,NC,1540,1041,499
37043950202,Clay,NC,1805,1324,481
37045950101,Cleveland,NC,2456,2149,307
37045950102,Cleveland,NC,1249,1091,158
37045950200,Cleveland,NC,2103,1847,256
37045950301,Cleveland,NC,2105,1914,191
37045950302,Cleveland,NC,2425,2279,146
37045950400,Cleveland,NC,3012,2817,195
37045950500,Cleveland,NC,1829,1625,204
37045950601,Cleveland,NC,1695,1573,122
37045950603,Cleveland,NC,1329,1230,99
37045950604,Cleveland,NC,1211,1110,101
37045950701,Cleveland,NC,1778,1649,129
37045950702,Cleveland,NC,1748,1626,122
37045950800,Cleveland,NC,2066,1913,153
37045950900,Cleveland,NC,1469,1307,162
37045951000,Cleveland,NC,1622,1440,182
37045951100,Cleveland,NC,1484,1330,154
37045951200,Cleveland,NC,2533,2314,219
37045951300,Cleveland,NC,1222,1135,87
37045951400,Cleveland,NC,2797,2600,197
37045951501,Cleveland,NC,2017,1879,138
37045951502,Cleveland,NC,586,531,55
37045951503,Cleveland,NC,1018,956,62
37045951601,Cleveland,NC,1791,1659,132
37045951602,Cleveland,NC,2085,1913,172
37047930100,Columbus,NC,1766,1575,191
37047930200,Columbus,NC,856,730,126
37047930300,Columbus,NC,1482,1000,482
37047930400,Columbus,NC,1739,1494,245
37047930500,Columbus,NC,1918,1699,219
37047930600,Columbus,NC,1466,1229,237
37047930700,Columbus,NC,2049,1751,298
37047930800,Columbus,NC,1720,1600,120
37047930900,Columbus,NC,2104,1820,284
37047931000,Columbus,NC,2017,1795,222
37047931100,Columbus,NC,1576,1449,127
37047931201,Columbus,NC,1847,1633,214
37047931202,Columbus,NC,809,731,78
37047931301,Columbus,NC,1058,946,112
37047931302,Columbus,NC,1026,916,110
37049960101,Craven,NC,2237,1793,444
37049960102,Craven,NC,2182,1902,280
37049960201,Craven,NC,1608,1416,192
37049960202,Craven,NC,1868,1589,279
37049960301,Craven,NC,1452,1259,193
37049960302,Craven,NC,1554,1326,228
37049960401,Craven,NC,2413,2299,114
37049960402,Craven,NC,1801,1623,178
37049960403,Craven,NC,1843,1741,102
37049960404,Craven,NC,1609,1390,219
37049960501,Craven,NC,2070,1950,120
37049960502,Craven,NC,1898,1627,271
37049960600,Craven,NC,2534,2250,284
37049960700,Craven,NC,1008,862,146
37049960800,Craven,NC,1554,1209,345
37049960900,Craven,NC,1283,895,388
37049961002,Craven,NC,1794,1560,234
37049961003,Craven,NC,2703,2561,142
37049961004,Craven,NC,2249,2048,201
37049961101,Craven,NC,2258,2082,176
37049961102,Craven,NC,1687,1474,213
37049961201,Craven,NC,1048,860,188
37049961202,Craven,NC,243,169,74
37049961301,Craven,NC,1607,1364,243
37049961302,Craven,NC,2317,2091,226
37049961303,Craven,NC,1980,1592,388
37051000200,Cumberland,NC,1154,918,236
37051000500,Cumberland,NC,1000,868,132
37051000600,Cumberland,NC,2726,2528,198
37051000701,Cumberland,NC,2419,2265,154
37051000702,Cumberland,NC,1163,1018,145
37051000800,Cumberland,NC,1556,1367,189
37051000900,Cumberland,NC,2533,2249,284
37051001000,Cumberland,NC,1336,1067,269
37051001100,Cumberland,NC,1452,1258,194
37051001200,Cumberland,NC,2795,2472,323
37051001401,Cumberland,NC,1548,1412,136
37051001402,Cumberland,NC,1165,1018,147
37051001500,Cumberland,NC,1206,1092,114
37051001603,Cumberland,NC,1593,1444,149
37051001604,Cumberland,NC,3236,3025,211
37051001605,Cumberland,NC,1654,1531,123
37051001606,Cumberland,NC,1543,1431,112
37051001701,Cumberland,NC,1266,1142,124
37051001702,Cumberland,NC,2269,2059,210
37051001800,Cumberland,NC,1088,996,92
37051001901,Cumberland,NC,946,861,85
37051001902,Cumberland,NC,1924,1713,211
37051001903,Cumberland,NC,1992,1790,202
37051002001,Cumberland,NC,1580,1359,221
37051002002,Cumberland,NC,2219,2050,169
37051002100,Cumberland,NC,2053,1904,149
37051002200,Cumberland,NC,1466,1242,224
37051002301,Cumberland,NC,1737,1613,124
37051002302,Cumberland,NC,570,461,109
37051002401,Cumberland,NC,856,651,205
37051002402,Cumberland,NC,1862,1647,215
37051002501,Cumberland,NC,3548,3295,253
37051002503,Cumberland,NC,2494,2280,214
37051002504,Cumberland,NC,3370,3109,261
37051002505,Cumberland,NC,1587,1486,101
37051002506,Cumberland,NC,1681,1568,113
37051002600,Cumberland,NC,2168,1902,266
37051002701,Cumberland,NC,1226,1105,121
37051002702,Cumberland,NC,2204,2082,122
37051002801,Cumberland,NC,1877,1710,167
37051002802,Cumberland,NC,1118,1019,99
37051002900,Cumberland,NC,1929,1658,271
37051003002,Cumberland,NC,1163,1081,82
37051003003,Cumberland,NC,2467,2355,112
37051003004,Cumberland,NC,2823,2676,147
37051003102,Cumberland,NC,2207,2073,134
37051003103,Cumberland,NC,2561,2446,115
37051003105,Cumberland,NC,1714,1633,81
37051003106,Cumberland,NC,881,798,83
37051003203,Cumberland,NC,2655,2389,266
37051003205,Cumberland,NC,2032,1920,112
37051003206,Cumberland,NC,2041,1959,82
37051003207,Cumberland,NC,2639,2522,117
37051003208,Cumberland,NC,1804,1615,189
37051003209,Cumberland,NC,1771,1685,86
37051003302,Cumberland,NC,2806,2556,250
37051003304,Cumberland,NC,3437,3145,292
37051003307,Cumberland,NC,1692,1555,137
37051003310,Cumberland,NC,2327,2047,280
37051003311,Cumberland,NC,1618,1486,132
37051003312,Cumberland,NC,2774,2564,210
37051003313,Cumberland,NC,2632,2458,174
37051003314,Cumberland,NC,3004,2771,233
37051003315,Cumberland,NC,2002,1778,224
37051003316,Cumberland,NC,1048,917,131
37051003317,Cumberland,NC,1632,1517,115
37051003318,Cumberland,NC,1219,1102,117
37051003401,Cumberland,NC,930,688,242
37051003403,Cumberland,NC,1014,841,173
37051003404,Cumberland,NC,31,26,5
37051003408,Cumberland,NC,1742,1586,156
37051003409,Cumberland,NC,385,367,18
37051003410,Cumberland,NC,648,574,74
37051003501,Cumberland,NC,1748,1557,191
37051003502,Cumberland,NC,962,780,182
37051003601,Cumberland,NC,1517,1296,221
37051003602,Cumberland,NC,971,822,149
37051003700,Cumberland,NC,3043,2806,237
37051003800,Cumberland,NC,1115,911,204
37051980100,Cumberland,NC,9,9,0
37051980200,Cumberland,NC,2,2,0
37053110101,Currituck,NC,4777,693,4084
37053110102,Currituck,NC,707,610,97
37053110201,Currituck,NC,1814,1742,72
37053110202,Currituck,NC,1458,1376,82
37053110301,Currituck,NC,1946,1794,152
37053110302,Currituck,NC,1411,1278,133
37053110401,Currituck,NC,1819,1471,348
37053110403,Currituck,NC,852,720,132
37053110404,Currituck,NC,1205,1039,166
37053990100,Currituck,NC,0,0,0
37055970101,Dare,NC,5271,1977,3294
37055970102,Dare,NC,2977,1531,1446
37055970200,Dare,NC,4418,2237,2181
37055970301,Dare,NC,2408,1717,691
37055970302,Dare,NC,3052,1287,1765
37055970400,Dare,NC,5142,1413,3729
37055970501,Dare,NC,690,466,224
37055970502,Dare,NC,5994,2019,3975
37055970601,Dare,NC,3519,2637,882
37055970602,Dare,NC,766,682,84
37055990100,Dare,NC,0,0,0
37055990200,Dare,NC,0,0,0
37057060101,Davidson,NC,2768,2636,132
37057060103,Davidson,NC,1206,1143,63
37057060104,Davidson,NC,2175,2065,110
37057060201,Davidson,NC,2106,1998,108
37057060202,Davidson,NC,951,909,42
37057060203,Davidson,NC,2560,2444,116
37057060301,Davidson,NC,2132,2030,102
37057060302,Davidson,NC,2044,1977,67
37057060303,Davidson,NC,1970,1838,132
37057060304,Davidson,NC,1463,1382,81
37057060400,Davidson,NC,2449,2275,174
37057060500,Davidson,NC,2405,2203,202
37057060601,Davidson,NC,1724,1646,78
37057060602,Davidson,NC,1325,1257,68
37057060700,Davidson,NC,2330,2064,266
37057060800,Davidson,NC,1963,1715,248
37057060900,Davidson,NC,2186,2009,177
37057061000,Davidson,NC,2299,2127,172
37057061101,Davidson,NC,1217,1169,48
37057061102,Davidson,NC,1937,1824,113
37057061202,Davidson,NC,1410,1303,107
37057061203,Davidson,NC,1701,1579,122
37057061204,Davidson,NC,1222,1076,146
37057061300,Davidson,NC,1095,945,150
37057061400,Davidson,NC,1296,1074,222
37057061501,Davidson,NC,2178,1884,294
37057061502,Davidson,NC,1091,1017,74
37057061600,Davidson,NC,1446,1294,152
37057061701,Davidson,NC,2218,2075,143
37057061703,Davidson,NC,1750,1648,102
37057061704,Davidson,NC,1637,1487,150
37057061705,Davidson,NC,1348,1233,115
37057061803,Davidson,NC,1437,1350,87
37057061805,Davidson,NC,1147,1103,44
37057061806,Davidson,NC,1629,1408,221
37057061807,Davidson,NC,1305,1096,209
37057061808,Davidson,NC,2043,1677,366
37057061902,Davidson,NC,2352,2170,182
37057061903,Davidson,NC,1506,1389,117
37057061904,Davidson,NC,1186,1095,91
37057062001,Davidson,NC,2573,1946,627
37057062002,Davidson,NC,1756,1566,190
37059080101,Davie,NC,1807,1655,152
37059080102,Davie,NC,1513,1372,141
37059080200,Davie,NC,2460,2306,154
37059080301,Davie,NC,2630,2440,190
37059080302,Davie,NC,1485,1377,108
37059080400,Davie,NC,2305,2140,165
37059080500,Davie,NC,1943,1804,139
37059080600,Davie,NC,1947,1814,133
37059080701,Davie,NC,1475,1306,169
37059080702,Davie,NC,1188,1042,146
37061090101,Duplin,NC,1178,1016,162
37061090102,Duplin,NC,1438,1124,314
37061090103,Duplin,NC,684,530,154
37061090201,Duplin,NC,646,487,159
37061090202,Duplin,NC,1027,796,231
37061090301,Duplin,NC,1366,1031,335
37061090302,Duplin,NC,1130,910,220
37061090401,Duplin,NC,1225,940,285
37061090402,Duplin,NC,1232,1026,206
37061090503,Duplin,NC,1640,1401,239
37061090504,Duplin,NC,737,650,87
37061090505,Duplin,NC,1200,999,201
37061090506,Duplin,NC,844,706,138
37061090600,Duplin,NC,1543,1250,293
37061090703,Duplin,NC,947,769,178
37061090704,Duplin,NC,915,716,199
37061090705,Duplin,NC,1203,1010,193
37061090706,Duplin,NC,1389,1142,247
37061090801,Duplin,NC,1288,1014,274
37061090803,Duplin,NC,838,675,163
37061090804,Duplin,NC,1234,1003,231
37063000101,Durham,NC,1360,1261,99
37063000102,Durham,NC,1980,1872,108
37063000200,Durham,NC,1365,1239,126
37063000301,Durham,NC,1415,1305,110
37063000302,Durham,NC,1815,1697,118
37063000401,Durham,NC,1180,1111,69
37063000402,Durham,NC,1805,1708,97
37063000500,Durham,NC,1898,1678,220
37063000600,Durham,NC,2366,2213,153
37063000700,Durham,NC,2394,1938,456
37063000900,Durham,NC,851,690,161
37063001001,Durham,NC,1556,1378,178
37063001002,Durham,NC,2338,2145,193
37063001100,Durham,NC,1528,1379,149
37063001301,Durham,NC,774,637,137
37063001303,Durham,NC,858,700,158
37063001304,Durham,NC,1245,1153,92
37063001400,Durham,NC,1139,969,170
37063001501,Durham,NC,20,19,1
37063001503,Durham,NC,16,14,2
37063001504,Durham,NC,1799,1554,245
37063001505,Durham,NC,2417,2191,226
37063001601,Durham,NC,2386,2310,76
37063001603,Durham,NC,2713,2611,102
37063001604,Durham,NC,2759,2648,111
37063001705,Durham,NC,2682,2499,183
37063001706,Durham,NC,2709,2567,142
37063001708,Durham,NC,1885,1795,90
37063001709,Durham,NC,3179,2994,185
37063001710,Durham,NC,1900,1779,121
37063001711,Durham,NC,2431,2246,185
37063001712,Durham,NC,2018,1933,85
37063001713,Durham,NC,1482,1436,46
37063001801,Durham,NC,3073,2909,164
37063001802,Durham,NC,2636,2481,155
37063001806,Durham,NC,2641,2492,149
37063001808,Durham,NC,4495,4377,118
37063001809,Durham,NC,3641,3397,244
37063001810,Durham,NC,1316,1268,48
37063001811,Durham,NC,2383,2320,63
37063001900,Durham,NC,3282,3097,185
37063002007,Durham,NC,2367,2250,117
37063002008,Durham,NC,1248,1201,47
37063002009,Durham,NC,2026,1875,151
37063002013,Durham,NC,2075,1986,89
37063002015,Durham,NC,2843,2449,394
37063002019,Durham,NC,2745,2614,131
37063002020,Durham,NC,3093,3016,77
37063002021,Durham,NC,2326,2236,90
37063002022,Durham,NC,2416,2308,108
37063002023,Durham,NC,1393,1352,41
37063002024,Durham,NC,3285,3210,75
37063002025,Durham,NC,2644,2548,96
37063002026,Durham,NC,3133,2982,151
37063002029,Durham,NC,1891,1801,90
37063002030,Durham,NC,1848,1719,129
37063002031,Durham,NC,1107,1048,59
37063002032,Durham,NC,1663,1546,117
37063002033,Durham,NC,2288,2113,175
37063002034,Durham,NC,3319,2966,353
37063002035,Durham,NC,3105,2962,143
37063002036,Durham,NC,2655,2365,290
37063002037,Durham,NC,4154,3751,403
37063002038,Durham,NC,2954,2783,171
37063002100,Durham,NC,2849,2673,176
37063002200,Durham,NC,1982,1717,265
37063002300,Durham,NC,1416,1168,248
37063980100,Durham,NC,4,4,0
37065020200,Edgecombe,NC,2465,2044,421
37065020300,Edgecombe,NC,2537,2111,426
37065020400,Edgecombe,NC,2230,1806,424
37065020600,Edgecombe,NC,1113,987,126
37065020700,Edgecombe,NC,901,742,159
37065020800,Edgecombe,NC,1435,1292,143
37065020900,Edgecombe,NC,1000,808,192
37065021000,Edgecombe,NC,1505,1258,247
37065021100,Edgecombe,NC,1647,1503,144
37065021200,Edgecombe,NC,2336,2172,164
37065021300,Edgecombe,NC,1751,1587,164
37065021400,Edgecombe,NC,1551,1391,160
37065021500,Edgecombe,NC,1384,1195,189
37065021600,Edgecombe,NC,1204,1075,129
37067000100,Forsyth,NC,2233,1844,389
37067000200,Forsyth,NC,826,717,109
37067000301,Forsyth,NC,916,852,64
37067000302,Forsyth,NC,905,747,158
37067000400,Forsyth,NC,1375,1161,214
37067000500,Forsyth,NC,1049,869,180
37067000600,Forsyth,NC,1094,960,134
37067000700,Forsyth,NC,916,732,184
37067000801,Forsyth,NC,329,266,63
37067000802,Forsyth,NC,693,625,68
37067000900,Forsyth,NC,1959,1713,246
37067001000,Forsyth,NC,2109,1849,260
37067001100,Forsyth,NC,1658,1526,132
37067001200,Forsyth,NC,1269,1057,212
37067001300,Forsyth,NC,889,746,143
37067001400,Forsyth,NC,1538,1355,183
37067001500,Forsyth,NC,1650,1484,166
37067001601,Forsyth,NC,1591,1458,133
37067001602,Forsyth,NC,1485,1285,200
37067001700,Forsyth,NC,2496,2103,393
37067001800,Forsyth,NC,1679,1557,122
37067001901,Forsyth,NC,585,512,73
37067001902,Forsyth,NC,942,846,96
37067002001,Forsyth,NC,1035,953,82
37067002002,Forsyth,NC,1405,1313,92
37067002100,Forsyth,NC,1063,977,86
37067002200,Forsyth,NC,2094,1803,291
37067002501,Forsyth,NC,1245,1163,82
37067002502,Forsyth,NC,1328,1232,96
37067002601,Forsyth,NC,1310,1195,115
37067002604,Forsyth,NC,2468,2358,110
37067002605,Forsyth,NC,1241,1172,69
37067002606,Forsyth,NC,2076,1945,131
37067002701,Forsyth,NC,2886,2613,273
37067002702,Forsyth,NC,3170,2834,336
37067002704,Forsyth,NC,1787,1587,200
37067002705,Forsyth,NC,1968,1631,337
37067002801,Forsyth,NC,1978,1852,126
37067002804,Forsyth,NC,1506,1411,95
37067002806,Forsyth,NC,1588,1477,111
37067002807,Forsyth,NC,2223,2039,184
37067002808,Forsyth,NC,1722,1623,99
37067002809,Forsyth,NC,1341,1264,77
37067002901,Forsyth,NC,2017,1848,169
37067002903,Forsyth,NC,1593,1433,160
37067002904,Forsyth,NC,992,908,84
37067003002,Forsyth,NC,1837,1698,139
37067003003,Forsyth,NC,1498,1422,76
37067003004,Forsyth,NC,1617,1562,55
37067003103,Forsyth,NC,2402,2284,118
37067003105,Forsyth,NC,1650,1527,123
37067003106,Forsyth,NC,1409,1296,113
37067003107,Forsyth,NC,1894,1826,68
37067003108,Forsyth,NC,1537,1429,108
37067003201,Forsyth,NC,2365,2215,150
37067003202,Forsyth,NC,2074,1963,111
37067003307,Forsyth,NC,1769,1671,98
37067003308,Forsyth,NC,3315,3192,123
37067003309,Forsyth,NC,2211,2113,98
37067003310,Forsyth,NC,1584,1490,94
37067003311,Forsyth,NC,751,728,23
37067003312,Forsyth,NC,2103,1923,180
37067003313,Forsyth,NC,660,581,79
37067003314,Forsyth,NC,1382,1305,77
37067003315,Forsyth,NC,1940,1836,104
37067003402,Forsyth,NC,1036,955,81
37067003403,Forsyth,NC,1370,1263,107
37067003404,Forsyth,NC,1576,1422,154
37067003500,Forsyth,NC,3247,3044,203
37067003600,Forsyth,NC,2848,2678,170
37067003701,Forsyth,NC,2736,2308,428
37067003702,Forsyth,NC,2399,2268,131
37067003703,Forsyth,NC,3577,3385,192
37067003803,Forsyth,NC,2474,2290,184
37067003804,Forsyth,NC,2738,2535,203
37067003805,Forsyth,NC,3342,3055,287
37067003806,Forsyth,NC,1348,1257,91
37067003903,Forsyth,NC,2449,2280,169
37067003904,Forsyth,NC,3466,3254,212
37067003905,Forsyth,NC,2179,2051,128
37067003906,Forsyth,NC,1471,1415,56
37067003908,Forsyth,NC,1342,1285,57
37067003909,Forsyth,NC,2171,2070,101
37067004005,Forsyth,NC,1995,1946,49
37067004007,Forsyth,NC,3028,2889,139
37067004009,Forsyth,NC,1792,1704,88
37067004010,Forsyth,NC,2149,1988,161
37067004011,Forsyth,NC,2503,2383,120
37067004012,Forsyth,NC,2521,2421,100
37067004013,Forsyth,NC,1808,1672,136
37067004014,Forsyth,NC,1527,1439,88
37067004015,Forsyth,NC,1955,1826,129
37067004102,Forsyth,NC,1360,1256,104
37067004103,Forsyth,NC,1766,1644,122
37067004104,Forsyth,NC,1783,1696,87
37069060100,Franklin,NC,2012,1787,225
37069060200,Franklin,NC,1727,1460,267
37069060301,Franklin,NC,2287,1977,310
37069060302,Franklin,NC,1171,1051,120
37069060401,Franklin,NC,1135,1058,77
37069060403,Franklin,NC,1182,1078,104
37069060404,Franklin,NC,1428,1275,153
37069060501,Franklin,NC,3719,3564,155
37069060502,Franklin,NC,3685,3563,122
37069060601,Franklin,NC,1166,1103,63
37069060602,Franklin,NC,2669,2499,170
37069060701,Franklin,NC,491,443,48
37069060702,Franklin,NC,1265,897,368
37069060703,Franklin,NC,1717,1114,603
37069060801,Franklin,NC,1514,1375,139
37069060802,Franklin,NC,2190,2056,134
37071030103,Gaston,NC,736,695,41
37071030104,Gaston,NC,999,909,90
37071030105,Gaston,NC,1336,1259,77
37071030106,Gaston,NC,597,520,77
37071030205,Gaston,NC,1647,1518,129
37071030206,Gaston,NC,799,776,23
37071030207,Gaston,NC,471,430,41
37071030208,Gaston,NC,245,233,12
37071030209,Gaston,NC,789,708,81
37071030301,Gaston,NC,1060,963,97
37071030302,Gaston,NC,1149,1062,87
37071030401,Gaston,NC,1760,1636,124
37071030403,Gaston,NC,838,771,67
37071030404,Gaston,NC,1036,961,75
37071030501,Gaston,NC,1096,986,110
37071030503,Gaston,NC,964,828,136
37071030504,Gaston,NC,763,683,80
37071030601,Gaston,NC,1207,1108,99
37071030602,Gaston,NC,1104,991,113
37071030700,Gaston,NC,1474,1313,161
37071030801,Gaston,NC,637,586,51
37071030802,Gaston,NC,1901,1733,168
37071030901,Gaston,NC,1185,1097,88
37071030902,Gaston,NC,1927,1811,116
37071031001,Gaston,NC,1178,1068,110
37071031004,Gaston,NC,1449,1368,81
37071031005,Gaston,NC,1068,1032,36
37071031006,Gaston,NC,734,702,32
37071031101,Gaston,NC,1219,1152,67
37071031102,Gaston,NC,1100,998,102
37071031202,Gaston,NC,906,824,82
37071031203,Gaston,NC,937,889,48
37071031204,Gaston,NC,812,748,64
37071031301,Gaston,NC,1736,1640,96
37071031303,Gaston,NC,803,731,72
37071031304,Gaston,NC,1265,1198,67
37071031401,Gaston,NC,1141,1062,79
37071031402,Gaston,NC,1036,998,38
37071031500,Gaston,NC,1524,1365,159
37071031600,Gaston,NC,1575,1452,123
37071031703,Gaston,NC,1255,1149,106
37071031704,Gaston,NC,1523,1407,116
37071031705,Gaston,NC,879,826,53
37071031706,Gaston,NC,659,600,59
37071031800,Gaston,NC,1423,1262,161
37071031901,Gaston,NC,279,233,46
37071031902,Gaston,NC,1092,935,157
37071032000,Gaston,NC,1182,1054,128
37071032100,Gaston,NC,1223,1123,100
37071032201,Gaston,NC,1215,1097,118
37071032202,Gaston,NC,964,894,70
37071032301,Gaston,NC,1705,1508,197
37071032302,Gaston,NC,1682,1519,163
37071032403,Gaston,NC,1322,1238,84
37071032404,Gaston,NC,1407,1318,89
37071032405,Gaston,NC,1258,1199,59
37071032406,Gaston,NC,949,884,65
37071032505,Gaston,NC,1942,1838,104
37071032506,Gaston,NC,1786,1679,107
37071032507,Gaston,NC,1567,1498,69
37071032508,Gaston,NC,1242,1140,102
37071032509,Gaston,NC,745,708,37
37071032510,Gaston,NC,1101,1009,92
37071032600,Gaston,NC,1639,1582,57
37071032702,Gaston,NC,1099,1034,65
37071032703,Gaston,NC,917,841,76
37071032704,Gaston,NC,2260,2111,149
37071032801,Gaston,NC,1283,1164,119
37071032802,Gaston,NC,1600,1493,107
37071032900,Gaston,NC,1870,1660,210
37071033100,Gaston,NC,1279,1181,98
37071033202,Gaston,NC,988,914,74
37071033203,Gaston,NC,1031,938,93
37071033204,Gaston,NC,1432,1320,112
37071033303,Gaston,NC,1468,1416,52
37071033306,Gaston,NC,614,592,22
37071033308,Gaston,NC,542,523,19
37071033309,Gaston,NC,796,757,39
37071033310,Gaston,NC,782,749,33
37071033311,Gaston,NC,323,305,18
37071033312,Gaston,NC,1384,1325,59
37071033313,Gaston,NC,916,890,26
37071033400,Gaston,NC,1167,1049,118
37071033501,Gaston,NC,1068,1005,63
37071033502,Gaston,NC,1075,1028,47
37073970100,Gates,NC,1945,1722,223
37073970200,Gates,NC,1481,1346,135
37073970300,Gates,NC,1341,1176,165
37075920100,Graham,NC,1903,931,972
37075920200,Graham,NC,1414,1058,356
37075920300,Graham,NC,1895,1328,567
37077970101,Granville,NC,2331,1994,337
37077970102,Granville,NC,1457,1314,143
37077970200,Granville,NC,1722,1591,131
37077970300,Granville,NC,1720,1578,142
37077970400,Granville,NC,1901,1722,179
37077970500,Granville,NC,1583,1468,115
37077970601,Granville,NC,2501,2381,120
37077970604,Granville,NC,1614,1522,92
37077970605,Granville,NC,2047,1977,70
37077970606,Granville,NC,957,894,63
37077970607,Granville,NC,2084,1929,155
37077970701,Granville,NC,2237,2102,135
37077970702,Granville,NC,839,811,28
37077970703,Granville,NC,1221,1178,43
37077970704,Granville,NC,0,0,0
37079950101,Greene,NC,1613,1405,208
37079950102,Greene,NC,1250,1102,148
37079950200,Greene,NC,1809,1654,155
37079950301,Greene,NC,1840,1629,211
37079950302,Greene,NC,1334,1194,140
37081010100,Guilford,NC,668,602,66
37081010200,Guilford,NC,2481,2271,210
37081010300,Guilford,NC,975,879,96
37081010401,Guilford,NC,850,796,54
37081010403,Guilford,NC,869,824,45
37081010404,Guilford,NC,1087,1037,50
37081010500,Guilford,NC,1190,1102,88
37081010601,Guilford,NC,1408,1297,111
37081010602,Guilford,NC,2093,1919,174
37081010701,Guilford,NC,1141,988,153
37081010702,Guilford,NC,1077,921,156
37081010800,Guilford,NC,1855,1494,361
37081010900,Guilford,NC,1226,1055,171
37081011000,Guilford,NC,735,593,142
37081011101,Guilford,NC,1858,1659,199
37081011102,Guilford,NC,1282,1144,138
37081011201,Guilford,NC,1567,1234,333
37081011202,Guilford,NC,1203,1069,134
37081011300,Guilford,NC,1400,1216,184
37081011400,Guilford,NC,2116,1941,175
37081011500,Guilford,NC,1263,1106,157
37081011601,Guilford,NC,1102,1014,88
37081011602,Guilford,NC,1266,1161,105
37081011904,Guilford,NC,2268,2159,109
37081011905,Guilford,NC,1941,1757,184
37081012503,Guilford,NC,2031,1931,100
37081012504,Guilford,NC,1602,1518,84
37081012505,Guilford,NC,1910,1832,78
37081012508,Guilford,NC,1719,1614,105
37081012509,Guilford,NC,1009,968,41
37081012510,Guilford,NC,1346,1302,44
37081012511,Guilford,NC,2090,2012,78
37081012604,Guilford,NC,2081,1912,169
37081012607,Guilford,NC,1053,1004,49
37081012608,Guilford,NC,1191,1068,123
37081012610,Guilford,NC,1209,1154,55
37081012611,Guilford,NC,1747,1667,80
37081012612,Guilford,NC,2731,2607,124
37081012617,Guilford,NC,1409,1330,79
37081012618,Guilford,NC,1914,1600,314
37081012619,Guilford,NC,1953,1802,151
37081012620,Guilford,NC,1800,1707,93
37081012621,Guilford,NC,1720,1590,130
37081012703,Guilford,NC,2629,2391,238
37081012704,Guilford,NC,1534,1411,123
37081012705,Guilford,NC,1678,1569,109
37081012706,Guilford,NC,1419,1309,110
37081012707,Guilford,NC,1117,980,137
37081012803,Guilford,NC,3593,3358,235
37081012804,Guilford,NC,1966,1855,111
37081012805,Guilford,NC,1489,1332,157
37081013601,Guilford,NC,509,445,64
37081013602,Guilford,NC,1788,1613,175
37081013700,Guilford,NC,1896,1701,195
37081013800,Guilford,NC,1876,1499,377
37081013900,Guilford,NC,1862,1663,199
37081014000,Guilford,NC,1396,1221,175
37081014200,Guilford,NC,1716,1507,209
37081014300,Guilford,NC,1371,1175,196
37081014406,Guilford,NC,1018,952,66
37081014407,Guilford,NC,2905,2706,199
37081014408,Guilford,NC,1011,931,80
37081014409,Guilford,NC,1484,1398,86
37081014410,Guilford,NC,2080,1874,206
37081014411,Guilford,NC,2145,1995,150
37081014412,Guilford,NC,1262,1197,65
37081014501,Guilford,NC,557,502,55
37081014502,Guilford,NC,1883,1759,124
37081014503,Guilford,NC,1420,1319,101
37081015100,Guilford,NC,2331,2186,145
37081015201,Guilford,NC,2397,2254,143
37081015202,Guilford,NC,2571,2480,91
37081015301,Guilford,NC,2320,2203,117
37081015302,Guilford,NC,1854,1763,91
37081015401,Guilford,NC,2245,2141,104
37081015402,Guilford,NC,3186,2938,248
37081015500,Guilford,NC,2817,2643,174
37081015601,Guilford,NC,1865,1783,82
37081015602,Guilford,NC,2346,2199,147
37081015703,Guilford,NC,3230,3062,168
37081015704,Guilford,NC,3211,3038,173
37081015705,Guilford,NC,1955,1729,226
37081015706,Guilford,NC,2433,2343,90
37081015707,Guilford,NC,3088,2979,109
37081015800,Guilford,NC,3160,3011,149
37081015901,Guilford,NC,2408,2252,156
37081015902,Guilford,NC,1647,1597,50
37081016003,Guilford,NC,1781,1714,67
37081016005,Guilford,NC,789,764,25
37081016006,Guilford,NC,2022,1925,97
37081016007,Guilford,NC,2798,2556,242
37081016008,Guilford,NC,3010,2901,109
37081016009,Guilford,NC,1491,1450,41
37081016010,Guilford,NC,1543,1489,54
37081016011,Guilford,NC,3197,3011,186
37081016101,Guilford,NC,2216,2045,171
37081016102,Guilford,NC,2165,1946,219
37081016103,Guilford,NC,2716,2484,232
37081016201,Guilford,NC,2546,2446,100
37081016203,Guilford,NC,2249,2129,120
37081016204,Guilford,NC,1588,1540,48
37081016205,Guilford,NC,1738,1680,58
37081016303,Guilford,NC,1496,1444,52
37081016304,Guilford,NC,1468,1421,47
37081016305,Guilford,NC,1412,1356,56
37081016306,Guilford,NC,2590,2477,113
37081016405,Guilford,NC,1006,914,92
37081016406,Guilford,NC,2410,2237,173
37081016407,Guilford,NC,1871,1782,89
37081016408,Guilford,NC,801,772,29
37081016409,Guilford,NC,1069,1023,46
37081016410,Guilford,NC,2235,2106,129
37081016502,Guilford,NC,2917,2731,186
37081016503,Guilford,NC,2989,2846,143
37081016505,Guilford,NC,2391,2257,134
37081016506,Guilford,NC,1809,1754,55
37081016600,Guilford,NC,1063,997,66
37081016701,Guilford,NC,2560,2457,103
37081016702,Guilford,NC,1625,1529,96
37081016800,Guilford,NC,3398,3126,272
37081016900,Guilford,NC,1992,1891,101
37081017000,Guilford,NC,2146,1984,162
37081017101,Guilford,NC,2240,2171,69
37081017102,Guilford,NC,1005,951,54
37081017200,Guilford,NC,3831,3597,234
37081980100,Guilford,NC,0,0,0
37083930100,Halifax,NC,1505,1197,308
37083930200,Halifax,NC,2551,2371,180
37083930300,Halifax,NC,2025,1760,265
37083930400,Halifax,NC,1628,1470,158
37083930501,Halifax,NC,1742,1570,172
37083930503,Halifax,NC,991,900,91
37083930504,Halifax,NC,1595,1434,161
37083930600,Halifax,NC,1944,1660,284
37083930701,Halifax,NC,608,506,102
37083930702,Halifax,NC,1886,1176,710
37083930800,Halifax,NC,2330,1966,364
37083930901,Halifax,NC,797,613,184
37083930902,Halifax,NC,1558,1206,352
37083931000,Halifax,NC,1194,955,239
37083931101,Halifax,NC,682,568,114
37083931102,Halifax,NC,1699,1355,344
37085070100,Harnett,NC,1827,1600,227
37085070200,Harnett,NC,1416,1281,135
37085070300,Harnett,NC,2232,2045,187
37085070401,Harnett,NC,1808,1634,174
37085070402,Harnett,NC,2716,2475,241
37085070500,Harnett,NC,2660,2402,258
37085070600,Harnett,NC,1975,1770,205
37085070700,Harnett,NC,2157,1895,262
37085070801,Harnett,NC,1050,981,69
37085070802,Harnett,NC,1980,1604,376
37085070901,Harnett,NC,1118,1055,63
37085070902,Harnett,NC,1184,1122,62
37085070903,Harnett,NC,937,860,77
37085070904,Harnett,NC,1583,1471,112
37085071002,Harnett,NC,1471,1385,86
37085071003,Harnett,NC,1617,1543,74
37085071004,Harnett,NC,744,720,24
37085071101,Harnett,NC,1384,1268,116
37085071102,Harnett,NC,2140,1909,231
37085071201,Harnett,NC,1249,1119,130
37085071202,Harnett,NC,1729,1597,132
37085071203,Harnett,NC,985,912,73
37085071204,Harnett,NC,2808,2561,247
37085071301,Harnett,NC,1807,1590,217
37085071302,Harnett,NC,2388,2258,130
37085071303,Harnett,NC,4284,3946,338
37085071401,Harnett,NC,1809,1635,174
37085071402,Harnett,NC,3818,3445,373
37087920101,Haywood,NC,2594,1755,839
37087920102,Haywood,NC,2279,1772,507
37087920201,Haywood,NC,629,542,87
37087920202,Haywood,NC,2426,2201,225
37087920300,Haywood,NC,1679,1501,178
37087920400,Haywood,NC,888,814,74
37087920501,Haywood,NC,940,836,104
37087920502,Haywood,NC,2148,1924,224
37087920601,Haywood,NC,1345,1057,288
37087920602,Haywood,NC,1844,1300,544
37087920701,Haywood,NC,2362,1121,1241
37087920702,Haywood,NC,1785,880,905
37087920800,Haywood,NC,2033,1481,552
37087920900,Haywood,NC,1023,872,151
37087921000,Haywood,NC,1660,1442,218
37087921100,Haywood,NC,1404,1153,251
37087921201,Haywood,NC,932,810,122
37087921202,Haywood,NC,2150,1816,334
37087921301,Haywood,NC,2163,1787,376
37087921302,Haywood,NC,2602,2129,473
37087980100,Haywood,NC,3,0,3
37089930100,Henderson,NC,2563,1910,653
37089930201,Henderson,NC,1687,1500,187
37089930202,Henderson,NC,1463,1239,224
37089930301,Henderson,NC,2079,1860,219
37089930302,Henderson,NC,1823,1609,214
37089930401,Henderson,NC,1177,1078,99
37089930402,Henderson,NC,1774,1374,400
37089930501,Henderson,NC,2329,2164,165
37089930502,Henderson,NC,2189,2041,148
37089930600,Henderson,NC,2503,2286,217
37089930701,Henderson,NC,1633,1459,174
37089930702,Henderson,NC,2032,1886,146
37089930703,Henderson,NC,2781,2541,240
37089930800,Henderson,NC,2173,1992,181
37089930900,Henderson,NC,1547,1427,120
37089931000,Henderson,NC,3033,2737,296
37089931100,Henderson,NC,1141,1026,115
37089931200,Henderson,NC,1205,1009,196
37089931300,Henderson,NC,1946,1735,211
37089931401,Henderson,NC,1478,1383,95
37089931402,Henderson,NC,1063,955,108
37089931500,Henderson,NC,2456,1958,498
37089931600,Henderson,NC,2532,2231,301
37089931700,Henderson,NC,1692,1404,288
37089931801,Henderson,NC,1751,1614,137
37089931802,Henderson,NC,2152,1922,230
37089931901,Henderson,NC,2152,1771,381
37089931902,Henderson,NC,1581,1318,263
37089932000,Henderson,NC,2499,1888,611
37089980100,Henderson,NC,0,0,0
37091950101,Hertford,NC,1183,1043,140
37091950102,Hertford,NC,1776,1477,299
37091950201,Hertford,NC,1175,948,227
37091950202,Hertford,NC,876,728,148
37091950300,Hertford,NC,1320,1158,162
37091950401,Hertford,NC,1483,1343,140
37091950402,Hertford,NC,1990,1654,336
37091980000,Hertford,NC,0,0,0
37093970104,Hoke,NC,1765,1650,115
37093970105,Hoke,NC,1971,1856,115
37093970106,Hoke,NC,2351,2166,185
37093970107,Hoke,NC,2777,2607,170
37093970108,Hoke,NC,2038,1913,125
37093970109,Hoke,NC,1238,1176,62
37093970201,Hoke,NC,1779,1617,162
37093970202,Hoke,NC,1587,1440,147
37093970300,Hoke,NC,2141,1891,250
37093970401,Hoke,NC,1378,1282,96
37093970402,Hoke,NC,1056,992,64
37093980100,Hoke,NC,2,0,2
37095920101,Hyde,NC,1956,1049,907
37095920102,Hyde,NC,1190,755,435
37095990100,Hyde,NC,0,0,0
37095990200,Hyde,NC,0,0,0
37097060100,Iredell,NC,2736,2530,206
37097060200,Iredell,NC,889,753,136
37097060300,Iredell,NC,1129,969,160
37097060400,Iredell,NC,1919,1709,210
37097060500,Iredell,NC,1923,1766,157
37097060601,Iredell,NC,2626,2503,123
37097060602,Iredell,NC,854,807,47
37097060603,Iredell,NC,661,608,53
37097060701,Iredell,NC,1240,1167,73
37097060702,Iredell,NC,1702,1584,118
37097060703,Iredell,NC,1191,1117,74
37097060801,Iredell,NC,1534,1354,180
37097060802,Iredell,NC,1534,1375,159
37097060901,Iredell,NC,1602,1335,267
37097060902,Iredell,NC,1670,1515,155
37097061001,Iredell,NC,1682,1576,106
37097061002,Iredell,NC,1730,1599,131
37097061003,Iredell,NC,1737,1632,105
37097061101,Iredell,NC,1163,1046,117
37097061102,Iredell,NC,1437,1306,131
37097061103,Iredell,NC,1247,1145,102
37097061104,Iredell,NC,926,883,43
37097061201,Iredell,NC,2042,1939,103
37097061202,Iredell,NC,2188,2052,136
37097061203,Iredell,NC,2814,2597,217
37097061204,Iredell,NC,1792,1527,265
37097061205,Iredell,NC,1937,1602,335
37097061301,Iredell,NC,1215,1099,116
37097061302,Iredell,NC,2000,1884,116
37097061303,Iredell,NC,1981,1888,93
37097061304,Iredell,NC,2433,2310,123
37097061401,Iredell,NC,2044,1796,248
37097061402,Iredell,NC,3486,3077,409
37097061403,Iredell,NC,1758,1666,92
37097061404,Iredell,NC,1585,1374,211
37097061405,Iredell,NC,1549,1412,137
37097061406,Iredell,NC,2116,1835,281
37097061407,Iredell,NC,2030,1898,132
37097061408,Iredell,NC,1759,1681,78
37097061501,Iredell,NC,1941,1825,116
37097061502,Iredell,NC,1890,1793,97
37097061503,Iredell,NC,1917,1814,103
37097061601,Iredell,NC,1465,1336,129
37097061603,Iredell,NC,2548,2366,182
37097061604,Iredell,NC,536,514,22
37097061605,Iredell,NC,1214,1142,72
37099940200,Jackson,NC,3079,2396,683
37099950200,Jackson,NC,1368,831,537
37099950300,Jackson,NC,2847,2317,530
37099950400,Jackson,NC,2303,1927,376
37099950500,Jackson,NC,3196,2396,800
37099950600,Jackson,NC,4402,3342,1060
37099950700,Jackson,NC,1939,1300,639
37099950800,Jackson,NC,2852,997,1855
37099950900,Jackson,NC,4663,1370,3293
37101040101,Johnston,NC,1292,1145,147
37101040102,Johnston,NC,985,921,64
37101040103,Johnston,NC,902,844,58
37101040204,Johnston,NC,1818,1689,129
37101040205,Johnston,NC,2421,2306,115
37101040206,Johnston,NC,1861,1709,152
37101040207,Johnston,NC,4400,4260,140
37101040208,Johnston,NC,1668,1583,85
37101040209,Johnston,NC,2388,2270,118
37101040210,Johnston,NC,783,766,17
37101040301,Johnston,NC,1802,1638,164
37101040303,Johnston,NC,1372,1202,170
37101040304,Johnston,NC,858,803,55
37101040400,Johnston,NC,2068,1964,104
37101040501,Johnston,NC,1972,1802,170
37101040502,Johnston,NC,874,814,60
37101040600,Johnston,NC,1540,1365,175
37101040700,Johnston,NC,1492,1347,145
37101040800,Johnston,NC,1513,1375,138
37101040903,Johnston,NC,3354,3164,190
37101040904,Johnston,NC,1659,1580,79
37101040905,Johnston,NC,1976,1905,71
37101040906,Johnston,NC,901,852,49
37101041001,Johnston,NC,4422,4135,287
37101041003,Johnston,NC,1642,1575,67
37101041004,Johnston,NC,1171,1080,91
37101041005,Johnston,NC,1667,1577,90
37101041104,Johnston,NC,1839,1777,62
37101041105,Johnston,NC,1544,1472,72
37101041106,Johnston,NC,1928,1848,80
37101041107,Johnston,NC,1831,1773,58
37101041108,Johnston,NC,1268,1237,31
37101041109,Johnston,NC,1252,1205,47
37101041110,Johnston,NC,1377,1317,60
37101041111,Johnston,NC,1483,1400,83
37101041112,Johnston,NC,2312,2202,110
37101041113,Johnston,NC,783,768,15
37101041203,Johnston,NC,849,756,93
37101041204,Johnston,NC,667,602,65
37101041205,Johnston,NC,1223,1069,154
37101041206,Johnston,NC,1118,1029,89
37101041301,Johnston,NC,913,812,101
37101041302,Johnston,NC,1705,1505,200
37101041401,Johnston,NC,1415,1273,142
37101041402,Johnston,NC,1953,1734,219
37101041504,Johnston,NC,1474,1417,57
37101041505,Johnston,NC,1756,1684,72
37101041506,Johnston,NC,876,834,42
37101041507,Johnston,NC,1533,1496,37
37101041508,Johnston,NC,1026,984,42
37101041509,Johnston,NC,1576,1492,84
37101041510,Johnston,NC,794,731,63
37101041511,Johnston,NC,1044,965,79
37103920100,Jones,NC,1803,1494,309
37103920200,Jones,NC,1242,1054,188
37103920300,Jones,NC,1590,1325,265
37105030101,Lee,NC,2204,2029,175
37105030102,Lee,NC,2455,2337,118
37105030200,Lee,NC,1247,1067,180
37105030300,Lee,NC,1115,931,184
37105030401,Lee,NC,1482,1331,151
37105030402,Lee,NC,2866,2713,153
37105030502,Lee,NC,827,775,52
37105030504,Lee,NC,2707,2547,160
37105030505,Lee,NC,1353,1252,101
37105030506,Lee,NC,607,559,48
37105030507,Lee,NC,1770,1649,121
37105030601,Lee,NC,1458,1371,87
37105030602,Lee,NC,2370,2212,158
37105030702,Lee,NC,1938,1804,134
37105030703,Lee,NC,825,760,65
37105030704,Lee,NC,1359,1238,121
37107010100,Lenoir,NC,2113,1855,258
37107010200,Lenoir,NC,1284,1018,266
37107010300,Lenoir,NC,828,631,197
37107010400,Lenoir,NC,543,341,202
37107010500,Lenoir,NC,1650,1337,313
37107010600,Lenoir,NC,1726,1484,242
37107010700,Lenoir,NC,1319,1076,243
37107010800,Lenoir,NC,2336,2101,235
37107010900,Lenoir,NC,1408,1211,197
37107011001,Lenoir,NC,2007,1834,173
37107011002,Lenoir,NC,1752,1582,170
37107011100,Lenoir,NC,2586,2224,362
37107011201,Lenoir,NC,1388,1234,154
37107011202,Lenoir,NC,1461,1320,141
37107011301,Lenoir,NC,804,706,98
37107011302,Lenoir,NC,1339,1213,126
37107011400,Lenoir,NC,2033,1763,270
37109070100,Lincoln,NC,2440,2176,264
37109070201,Lincoln,NC,2102,1867,235
37109070202,Lincoln,NC,1417,1347,70
37109070300,Lincoln,NC,1757,1636,121
37109070400,Lincoln,NC,2553,2362,191
37109070500,Lincoln,NC,2095,1905,190
37109070600,Lincoln,NC,1835,1659,176
37109070700,Lincoln,NC,1448,1345,103
37109070800,Lincoln,NC,2599,2425,174
37109070901,Lincoln,NC,1420,1343,77
37109070902,Lincoln,NC,2852,2715,137
37109071001,Lincoln,NC,2230,2076,154
37109071002,Lincoln,NC,1130,1053,77
37109071101,Lincoln,NC,3093,2842,251
37109071102,Lincoln,NC,2890,2732,158
37109071201,Lincoln,NC,895,802,93
37109071202,Lincoln,NC,1893,1728,165
37109071203,Lincoln,NC,2521,2293,228
37111970101,McDowell,NC,1189,891,298
37111970102,McDowell,NC,1784,1336,448
37111970200,McDowell,NC,2620,2073,547
37111970300,McDowell,NC,1328,1212,116
37111970400,McDowell,NC,1196,1053,143
37111970500,McDowell,NC,1800,1638,162
37111970600,McDowell,NC,1562,1451,111
37111970700,McDowell,NC,2121,1825,296
37111970800,McDowell,NC,2222,1819,403
37111970902,McDowell,NC,2288,2032,256
37111970903,McDowell,NC,1917,1637,280
37111970904,McDowell,NC,1215,1091,124
37113970100,Macon,NC,2128,1346,782
37113970200,Macon,NC,3413,1840,1573
37113970302,Macon,NC,2352,1915,437
37113970303,Macon,NC,1088,891,197
37113970304,Macon,NC,1272,1009,263
37113970400,Macon,NC,2937,1956,981
37113970501,Macon,NC,2552,752,1800
37113970502,Macon,NC,3004,943,2061
37113970600,Macon,NC,4222,2777,1445
37113970700,Macon,NC,3980,2950,1030
37115010100,Madison,NC,1835,1251,584
37115010200,Madison,NC,1458,1008,450
37115010400,Madison,NC,1019,833,186
37115010500,Madison,NC,2405,2082,323
37115010601,Madison,NC,1122,975,147
37115010602,Madison,NC,1748,1557,191
37115010700,Madison,NC,1458,1214,244
37117970100,Martin,NC,1888,1638,250
37117970200,Martin,NC,2062,1820,242
37117970300,Martin,NC,1958,1650,308
37117970400,Martin,NC,1263,1036,227
37117970500,Martin,NC,2454,2201,253
37117970600,Martin,NC,1455,1209,246
37119000101,Mecklenburg,NC,872,756,116
37119000102,Mecklenburg,NC,2277,1969,308
37119000103,Mecklenburg,NC,1274,1156,118
37119000104,Mecklenburg,NC,1692,1289,403
37119000301,Mecklenburg,NC,1033,931,102
37119000302,Mecklenburg,NC,1284,1141,143
37119000401,Mecklenburg,NC,1437,1314,123
37119000402,Mecklenburg,NC,1570,1440,130
37119000501,Mecklenburg,NC,1288,1125,163
37119000502,Mecklenburg,NC,1130,1014,116
37119000503,Mecklenburg,NC,1264,1130,134
37119000600,Mecklenburg,NC,1772,1576,196
37119000700,Mecklenburg,NC,1890,1593,297
37119000800,Mecklenburg,NC,1514,1393,121
37119000900,Mecklenburg,NC,1145,976,169
37119001000,Mecklenburg,NC,2087,1930,157
37119001100,Mecklenburg,NC,1999,1725,274
37119001200,Mecklenburg,NC,2462,2297,165
37119001300,Mecklenburg,NC,1919,1751,168
37119001400,Mecklenburg,NC,1918,1779,139
37119001504,Mecklenburg,NC,2523,2413,110
37119001505,Mecklenburg,NC,1736,1481,255
37119001507,Mecklenburg,NC,1682,1547,135
37119001508,Mecklenburg,NC,2589,2448,141
37119001509,Mecklenburg,NC,1196,1122,74
37119001510,Mecklenburg,NC,1292,1229,63
37119001603,Mecklenburg,NC,1814,1654,160
37119001605,Mecklenburg,NC,833,779,54
37119001606,Mecklenburg,NC,1715,1636,79
37119001607,Mecklenburg,NC,1174,974,200
37119001608,Mecklenburg,NC,1643,1529,114
37119001609,Mecklenburg,NC,1356,1296,60
37119001701,Mecklenburg,NC,1907,1832,75
37119001702,Mecklenburg,NC,2467,2339,128
37119001801,Mecklenburg,NC,741,695,46
37119001802,Mecklenburg,NC,1836,1739,97
37119001910,Mecklenburg,NC,1924,1790,134
37119001911,Mecklenburg,NC,2096,2031,65
37119001914,Mecklenburg,NC,1455,1390,65
37119001916,Mecklenburg,NC,1808,1707,101
37119001917,Mecklenburg,NC,1429,1364,65
37119001918,Mecklenburg,NC,1702,1577,125
37119001919,Mecklenburg,NC,1730,1639,91
37119001920,Mecklenburg,NC,1724,1624,100
37119001921,Mecklenburg,NC,834,802,32
37119001922,Mecklenburg,NC,1614,1567,47
37119001923,Mecklenburg,NC,1594,1476,118
37119001924,Mecklenburg,NC,1064,980,84
37119001925,Mecklenburg,NC,1801,1665,136
37119001926,Mecklenburg,NC,1867,1772,95
37119001927,Mecklenburg,NC,1465,1403,62
37119002004,Mecklenburg,NC,2299,2136,163
37119002005,Mecklenburg,NC,1331,1183,148
37119002006,Mecklenburg,NC,1693,1614,79
37119002007,Mecklenburg,NC,1184,1137,47
37119002008,Mecklenburg,NC,1295,1243,52
37119002100,Mecklenburg,NC,1437,1348,89
37119002201,Mecklenburg,NC,1201,1133,68
37119002202,Mecklenburg,NC,1516,1367,149
37119002300,Mecklenburg,NC,1208,1111,97
37119002400,Mecklenburg,NC,1830,1676,154
37119002500,Mecklenburg,NC,1554,1465,89
37119002600,Mecklenburg,NC,922,836,86
37119002701,Mecklenburg,NC,1163,1058,105
37119002702,Mecklenburg,NC,2272,2136,136
37119002800,Mecklenburg,NC,1514,1426,88
37119002903,Mecklenburg,NC,2383,2222,161
37119002905,Mecklenburg,NC,1793,1557,236
37119002907,Mecklenburg,NC,1604,1510,94
37119002908,Mecklenburg,NC,1746,1518,228
37119002909,Mecklenburg,NC,817,759,58
37119002910,Mecklenburg,NC,2050,1838,212
37119003006,Mecklenburg,NC,2016,1941,75
37119003008,Mecklenburg,NC,2559,2438,121
37119003012,Mecklenburg,NC,1882,1796,86
37119003013,Mecklenburg,NC,2239,2165,74
37119003015,Mecklenburg,NC,1833,1790,43
37119003016,Mecklenburg,NC,2072,1988,84
37119003017,Mecklenburg,NC,1553,1493,60
37119003018,Mecklenburg,NC,1246,1191,55
37119003019,Mecklenburg,NC,982,952,30
37119003020,Mecklenburg,NC,1692,1628,64
37119003021,Mecklenburg,NC,1119,1070,49
37119003022,Mecklenburg,NC,1850,1751,99
37119003102,Mecklenburg,NC,2273,2162,111
37119003105,Mecklenburg,NC,1789,1721,68
37119003106,Mecklenburg,NC,1818,1751,67
37119003108,Mecklenburg,NC,1566,1457,109
37119003109,Mecklenburg,NC,1865,1775,90
37119003110,Mecklenburg,NC,1085,1028,57
37119003111,Mecklenburg,NC,2156,1868,288
37119003201,Mecklenburg,NC,1143,1064,79
37119003203,Mecklenburg,NC,1699,1615,84
37119003204,Mecklenburg,NC,1944,1788,156
37119003301,Mecklenburg,NC,1487,1205,282
37119003302,Mecklenburg,NC,1390,1309,81
37119003401,Mecklenburg,NC,1534,1250,284
37119003402,Mecklenburg,NC,1863,1762,101
37119003500,Mecklenburg,NC,1667,1545,122
37119003600,Mecklenburg,NC,2138,1931,207
37119003701,Mecklenburg,NC,1651,1312,339
37119003702,Mecklenburg,NC,1191,1149,42
37119003802,Mecklenburg,NC,1640,1517,123
37119003805,Mecklenburg,NC,1804,1676,128
37119003807,Mecklenburg,NC,1654,1602,52
37119003808,Mecklenburg,NC,2090,1993,97
37119003809,Mecklenburg,NC,1423,1367,56
37119003810,Mecklenburg,NC,1721,1599,122
37119003811,Mecklenburg,NC,1212,1144,68
37119003902,Mecklenburg,NC,2030,1873,157
37119003903,Mecklenburg,NC,952,895,57
37119004000,Mecklenburg,NC,1913,1766,147
37119004101,Mecklenburg,NC,1187,1057,130
37119004102,Mecklenburg,NC,1522,1392,130
37119004200,Mecklenburg,NC,1471,1315,156
37119004302,Mecklenburg,NC,2080,1904,176
37119004303,Mecklenburg,NC,1167,1116,51
37119004304,Mecklenburg,NC,1476,1360,116
37119004306,Mecklenburg,NC,1260,1073,187
37119004307,Mecklenburg,NC,1124,1076,48
37119004400,Mecklenburg,NC,1649,1564,85
37119004500,Mecklenburg,NC,1301,1178,123
37119004600,Mecklenburg,NC,1279,1144,135
37119004700,Mecklenburg,NC,546,489,57
37119004800,Mecklenburg,NC,1723,1562,161
37119004900,Mecklenburg,NC,267,256,11
37119005000,Mecklenburg,NC,1099,1040,59
37119005100,Mecklenburg,NC,1218,1112,106
37119005200,Mecklenburg,NC,914,744,170
37119005301,Mecklenburg,NC,1514,1448,66
37119005305,Mecklenburg,NC,1674,1573,101
37119005306,Mecklenburg,NC,1040,953,87
37119005307,Mecklenburg,NC,1764,1620,144
37119005308,Mecklenburg,NC,1106,1042,64
37119005403,Mecklenburg,NC,1921,1857,64
37119005404,Mecklenburg,NC,2028,1933,95
37119005405,Mecklenburg,NC,1255,1209,46
37119005406,Mecklenburg,NC,1727,1630,97
37119005508,Mecklenburg,NC,1508,1473,35
37119005510,Mecklenburg,NC,2393,2276,117
37119005511,Mecklenburg,NC,2269,2102,167
37119005512,Mecklenburg,NC,2074,1971,103
37119005513,Mecklenburg,NC,1670,1614,56
37119005515,Mecklenburg,NC,1180,1118,62
37119005516,Mecklenburg,NC,613,591,22
37119005517,Mecklenburg,NC,1767,1709,58
37119005519,Mecklenburg,NC,2832,2593,239
37119005520,Mecklenburg,NC,1540,1508,32
37119005522,Mecklenburg,NC,2200,2071,129
37119005525,Mecklenburg,NC,1800,1692,108
37119005526,Mecklenburg,NC,1364,1312,52
37119005527,Mecklenburg,NC,1245,1211,34
37119005528,Mecklenburg,NC,1896,1829,67
37119005529,Mecklenburg,NC,800,753,47
37119005530,Mecklenburg,NC,1550,1473,77
37119005531,Mecklenburg,NC,2462,2332,130
37119005532,Mecklenburg,NC,1987,1796,191
37119005533,Mecklenburg,NC,934,772,162
37119005534,Mecklenburg,NC,2609,2433,176
37119005535,Mecklenburg,NC,1719,1633,86
37119005536,Mecklenburg,NC,2492,2370,122
37119005604,Mecklenburg,NC,1255,1065,190
37119005609,Mecklenburg,NC,1976,1661,315
37119005610,Mecklenburg,NC,1408,1321,87
37119005611,Mecklenburg,NC,1424,1350,74
37119005612,Mecklenburg,NC,2231,2139,92
37119005613,Mecklenburg,NC,1263,1218,45
37119005615,Mecklenburg,NC,900,878,22
37119005616,Mecklenburg,NC,641,611,30
37119005617,Mecklenburg,NC,1084,1045,39
37119005618,Mecklenburg,NC,1134,1103,31
37119005619,Mecklenburg,NC,1723,1690,33
37119005621,Mecklenburg,NC,2058,1981,77
37119005622,Mecklenburg,NC,1477,1337,140
37119005623,Mecklenburg,NC,2355,2166,189
37119005624,Mecklenburg,NC,926,897,29
37119005625,Mecklenburg,NC,2090,2005,85
37119005626,Mecklenburg,NC,1226,1181,45
37119005627,Mecklenburg,NC,2498,2414,84
37119005709,Mecklenburg,NC,1751,1675,76
37119005710,Mecklenburg,NC,1951,1781,170
37119005712,Mecklenburg,NC,1414,1376,38
37119005713,Mecklenburg,NC,1706,1635,71
37119005714,Mecklenburg,NC,2110,2024,86
37119005715,Mecklenburg,NC,1186,1125,61
37119005716,Mecklenburg,NC,1836,1764,72
37119005718,Mecklenburg,NC,1369,1331,38
37119005719,Mecklenburg,NC,1385,1332,53
37119005720,Mecklenburg,NC,1069,1009,60
37119005721,Mecklenburg,NC,1384,1341,43
37119005722,Mecklenburg,NC,972,960,12
37119005723,Mecklenburg,NC,1641,1560,81
37119005811,Mecklenburg,NC,2112,2045,67
37119005815,Mecklenburg,NC,1625,1566,59
37119005816,Mecklenburg,NC,1754,1707,47
37119005817,Mecklenburg,NC,1741,1687,54
37119005824,Mecklenburg,NC,1775,1683,92
37119005826,Mecklenburg,NC,1184,1147,37
37119005827,Mecklenburg,NC,1312,1243,69
37119005828,Mecklenburg,NC,1761,1712,49
37119005829,Mecklenburg,NC,1522,1337,185
37119005830,Mecklenburg,NC,1636,1566,70
37119005832,Mecklenburg,NC,1136,1091,45
37119005833,Mecklenburg,NC,2095,1962,133
37119005834,Mecklenburg,NC,1639,1568,71
37119005835,Mecklenburg,NC,975,955,20
37119005836,Mecklenburg,NC,1476,1443,33
37119005839,Mecklenburg,NC,1418,1339,79
37119005840,Mecklenburg,NC,969,897,72
37119005843,Mecklenburg,NC,1309,1281,28
37119005845,Mecklenburg,NC,2494,2200,294
37119005846,Mecklenburg,NC,1369,1334,35
37119005847,Mecklenburg,NC,2062,1964,98
37119005848,Mecklenburg,NC,1694,1674,20
37119005849,Mecklenburg,NC,1488,1448,40
37119005850,Mecklenburg,NC,1358,1236,122
37119005851,Mecklenburg,NC,1504,1476,28
37119005852,Mecklenburg,NC,980,943,37
37119005853,Mecklenburg,NC,1242,1180,62
37119005854,Mecklenburg,NC,1064,980,84
37119005855,Mecklenburg,NC,2143,2043,100
37119005856,Mecklenburg,NC,1113,1045,68
37119005857,Mecklenburg,NC,1193,1074,119
37119005858,Mecklenburg,NC,1971,1847,124
37119005859,Mecklenburg,NC,1424,1353,71
37119005860,Mecklenburg,NC,1567,1492,75
37119005861,Mecklenburg,NC,1457,1406,51
37119005862,Mecklenburg,NC,1164,1136,28
37119005863,Mecklenburg,NC,1288,1245,43
37119005864,Mecklenburg,NC,1896,1835,61
37119005865,Mecklenburg,NC,998,960,38
37119005866,Mecklenburg,NC,2319,2141,178
37119005867,Mecklenburg,NC,2030,1890,140
37119005868,Mecklenburg,NC,936,890,46
37119005908,Mecklenburg,NC,1070,914,156
37119005910,Mecklenburg,NC,2303,2193,110
37119005913,Mecklenburg,NC,2546,2451,95
37119005915,Mecklenburg,NC,1521,1447,74
37119005916,Mecklenburg,NC,1011,949,62
37119005918,Mecklenburg,NC,1665,1640,25
37119005919,Mecklenburg,NC,1592,1498,94
37119005920,Mecklenburg,NC,945,805,140
37119005921,Mecklenburg,NC,1755,1613,142
37119005922,Mecklenburg,NC,1683,1620,63
37119005923,Mecklenburg,NC,1976,1852,124
37119005924,Mecklenburg,NC,1857,1804,53
37119005925,Mecklenburg,NC,1162,1135,27
37119005926,Mecklenburg,NC,3011,2647,364
37119005927,Mecklenburg,NC,2443,2279,164
37119005928,Mecklenburg,NC,592,553,39
37119005929,Mecklenburg,NC,1644,1588,56
37119005930,Mecklenburg,NC,1339,1236,103
37119005931,Mecklenburg,NC,1878,1798,80
37119005932,Mecklenburg,NC,1036,999,37
37119006005,Mecklenburg,NC,1364,1318,46
37119006008,Mecklenburg,NC,1480,1441,39
37119006009,Mecklenburg,NC,1292,1243,49
37119006011,Mecklenburg,NC,1227,1174,53
37119006012,Mecklenburg,NC,1799,1702,97
37119006013,Mecklenburg,NC,1370,1330,40
37119006014,Mecklenburg,NC,1623,1585,38
37119006015,Mecklenburg,NC,1504,1456,48
37119006016,Mecklenburg,NC,1161,1098,63
37119006103,Mecklenburg,NC,2109,1875,234
37119006105,Mecklenburg,NC,1162,1123,39
37119006108,Mecklenburg,NC,1778,1713,65
37119006109,Mecklenburg,NC,1332,1279,53
37119006110,Mecklenburg,NC,2094,2004,90
37119006111,Mecklenburg,NC,1630,1569,61
37119006112,Mecklenburg,NC,1112,1065,47
37119006113,Mecklenburg,NC,1672,1574,98
37119006114,Mecklenburg,NC,1740,1637,103
37119006115,Mecklenburg,NC,2035,1828,207
37119006208,Mecklenburg,NC,1684,1597,87
37119006209,Mecklenburg,NC,2696,2533,163
37119006210,Mecklenburg,NC,1870,1801,69
37119006211,Mecklenburg,NC,2204,2130,74
37119006212,Mecklenburg,NC,1512,1474,38
37119006214,Mecklenburg,NC,1573,1555,18
37119006216,Mecklenburg,NC,1052,885,167
37119006217,Mecklenburg,NC,1766,1590,176
37119006218,Mecklenburg,NC,1092,1033,59
37119006219,Mecklenburg,NC,1011,939,72
37119006220,Mecklenburg,NC,1769,1484,285
37119006221,Mecklenburg,NC,1409,1381,28
37119006222,Mecklenburg,NC,1418,1352,66
37119006223,Mecklenburg,NC,1025,984,41
37119006224,Mecklenburg,NC,1497,1407,90
37119006305,Mecklenburg,NC,1353,1311,42
37119006306,Mecklenburg,NC,680,638,42
37119006307,Mecklenburg,NC,2495,2336,159
37119006308,Mecklenburg,NC,1786,1720,66
37119006309,Mecklenburg,NC,1010,960,50
37119006310,Mecklenburg,NC,1075,1034,41
37119006311,Mecklenburg,NC,1492,1453,39
37119006403,Mecklenburg,NC,2229,2078,151
37119006404,Mecklenburg,NC,2500,2368,132
37119006407,Mecklenburg,NC,1338,1305,33
37119006408,Mecklenburg,NC,1548,1474,74
37119006409,Mecklenburg,NC,1844,1764,80
37119006410,Mecklenburg,NC,1437,1357,80
37119006411,Mecklenburg,NC,1219,1150,69
37119980100,Mecklenburg,NC,1,1,0
37119980200,Mecklenburg,NC,1,1,0
37119980300,Mecklenburg,NC,24,24,0
37121950100,Mitchell,NC,1629,1071,558
37121950200,Mitchell,NC,2101,1617,484
37121950300,Mitchell,NC,2127,1787,340
37121950400,Mitchell,NC,2781,2137,644
37123960101,Montgomery,NC,738,646,92
37123960102,Montgomery,NC,1780,1575,205
37123960201,Montgomery,NC,789,701,88
37123960202,Montgomery,NC,2044,1795,249
37123960301,Montgomery,NC,1058,725,333
37123960302,Montgomery,NC,2675,1202,1473
37123960401,Montgomery,NC,918,787,131
37123960402,Montgomery,NC,2736,1191,1545
37123960501,Montgomery,NC,1087,908,179
37123960502,Montgomery,NC,948,803,145
37125950100,Moore,NC,1292,1021,271
37125950201,Moore,NC,1073,896,177
37125950202,Moore,NC,2000,1729,271
37125950303,Moore,NC,1228,936,292
37125950304,Moore,NC,1367,1135,232
37125950305,Moore,NC,2080,1676,404
37125950306,Moore,NC,930,801,129
37125950402,Moore,NC,1665,1491,174
37125950403,Moore,NC,1083,941,142
37125950404,Moore,NC,1142,973,169
37125950503,Moore,NC,1352,1213,139
37125950504,Moore,NC,1454,1301,153
37125950505,Moore,NC,353,321,32
37125950506,Moore,NC,2488,2355,133
37125950507,Moore,NC,1876,1662,214
37125950601,Moore,NC,1990,1721,269
37125950603,Moore,NC,1946,1755,191
37125950604,Moore,NC,1813,1592,221
37125950702,Moore,NC,1638,1270,368
37125950703,Moore,NC,1423,1199,224
37125950704,Moore,NC,1675,1204,471
37125950801,Moore,NC,3109,2693,416
37125950802,Moore,NC,2460,2125,335
37125950900,Moore,NC,1545,1377,168
37125951001,Moore,NC,2240,2022,218
37125951002,Moore,NC,467,448,19
37125951101,Moore,NC,1581,1431,150
37125951102,Moore,NC,2856,2667,189
37125951200,Moore,NC,2111,1926,185
37127010200,Nash,NC,2473,2152,321
37127010301,Nash,NC,1571,1446,125
37127010302,Nash,NC,1354,1253,101
37127010400,Nash,NC,1701,1323,378
37127010503,Nash,NC,1254,1140,114
37127010504,Nash,NC,2481,2283,198
37127010505,Nash,NC,2030,1830,200
37127010506,Nash,NC,1843,1713,130
37127010601,Nash,NC,1194,1107,87
37127010603,Nash,NC,625,559,66
37127010604,Nash,NC,1864,1740,124
37127010700,Nash,NC,1392,1217,175
37127010801,Nash,NC,601,535,66
37127010802,Nash,NC,2451,2327,124
37127010900,Nash,NC,2424,2167,257
37127011000,Nash,NC,2057,1794,263
37127011101,Nash,NC,2537,2435,102
37127011103,Nash,NC,2486,2235,251
37127011104,Nash,NC,914,796,118
37127011201,Nash,NC,1530,1382,148
37127011202,Nash,NC,1452,1374,78
37127011300,Nash,NC,2004,1823,181
37127011400,Nash,NC,1881,1742,139
37127011501,Nash,NC,1254,1129,125
37127011502,Nash,NC,1781,1591,190
37129010100,New Hanover,NC,1312,1093,219
37129010200,New Hanover,NC,1818,1578,240
37129010300,New Hanover,NC,2659,2428,231
37129010400,New Hanover,NC,1249,1130,119
37129010501,New Hanover,NC,2026,1796,230
37129010503,New Hanover,NC,1206,1093,113
37129010504,New Hanover,NC,3340,2996,344
37129010600,New Hanover,NC,2397,2209,188
37129010700,New Hanover,NC,1909,1708,201
37129010800,New Hanover,NC,1037,947,90
37129010900,New Hanover,NC,1220,1124,96
37129011000,New Hanover,NC,1223,1068,155
37129011100,New Hanover,NC,1481,1181,300
37129011200,New Hanover,NC,1298,1037,261
37129011300,New Hanover,NC,1887,1350,537
37129011400,New Hanover,NC,913,832,81
37129011501,New Hanover,NC,1814,1578,236
37129011502,New Hanover,NC,858,795,63
37129011503,New Hanover,NC,1569,1424,145
37129011504,New Hanover,NC,2152,2026,126
37129011605,New Hanover,NC,2464,2330,134
37129011606,New Hanover,NC,1998,1852,146
37129011608,New Hanover,NC,2804,2456,348
37129011609,New Hanover,NC,1958,1863,95
37129011610,New Hanover,NC,1481,1382,99
37129011611,New Hanover,NC,2953,2790,163
37129011612,New Hanover,NC,2654,2557,97
37129011701,New Hanover,NC,2874,2334,540
37129011703,New Hanover,NC,2587,2298,289
37129011705,New Hanover,NC,4082,3785,297
37129011800,New Hanover,NC,2804,1180,1624
37129011904,New Hanover,NC,1691,1469,222
37129011905,New Hanover,NC,1238,1114,124
37129011906,New Hanover,NC,1634,1487,147
37129012004,New Hanover,NC,1571,1493,78
37129012006,New Hanover,NC,1983,1845,138
37129012007,New Hanover,NC,3248,2985,263
37129012008,New Hanover,NC,3554,3285,269
37129012009,New Hanover,NC,2847,2701,146
37129012010,New Hanover,NC,2171,2051,120
37129012011,New Hanover,NC,2012,1891,121
37129012012,New Hanover,NC,1137,1016,121
37129012103,New Hanover,NC,1971,1888,83
37129012106,New Hanover,NC,3709,3496,213
37129012107,New Hanover,NC,2105,1913,192
37129012108,New Hanover,NC,1552,1418,134
37129012109,New Hanover,NC,1591,1468,123
37129012110,New Hanover,NC,1975,1864,111
37129012111,New Hanover,NC,3226,2713,513
37129012201,New Hanover,NC,2640,1428,1212
37129012202,New Hanover,NC,2981,1664,1317
37129012203,New Hanover,NC,2130,1046,1084
37129012300,New Hanover,NC,4374,3653,721
37129980100,New Hanover,NC,1,1,0
37129990100,New Hanover,NC,0,0,0
37131920101,Northampton,NC,823,651,172
37131920102,Northampton,NC,717,616,101
37131920103,Northampton,NC,860,738,122
37131920201,Northampton,NC,567,415,152
37131920202,Northampton,NC,1371,940,431
37131920301,Northampton,NC,1044,838,206
37131920302,Northampton,NC,916,740,176
37131920303,Northampton,NC,638,535,103
37131920401,Northampton,NC,1931,1549,382
37131920402,Northampton,NC,1703,779,924
37133000103,Onslow,NC,2747,2393,354
37133000104,Onslow,NC,1190,1028,162
37133000105,Onslow,NC,3551,2915,636
37133000203,Onslow,NC,1672,1538,134
37133000204,Onslow,NC,1729,1567,162
37133000205,Onslow,NC,2886,2533,353
37133000206,Onslow,NC,1593,1430,163
37133000207,Onslow,NC,1792,1575,217
37133000303,Onslow,NC,889,751,138
37133000304,Onslow,NC,1926,1633,293
37133000305,Onslow,NC,1405,1167,238
37133000306,Onslow,NC,3017,2541,476
37133000401,Onslow,NC,4987,3938,1049
37133000403,Onslow,NC,3399,717,2682
37133000404,Onslow,NC,868,641,227
37133000405,Onslow,NC,4175,3157,1018
37133000500,Onslow,NC,11,11,0
37133000600,Onslow,NC,58,58,0
37133000700,Onslow,NC,1915,1597,318
37133000800,Onslow,NC,201,177,24
37133000901,Onslow,NC,623,473,150
37133000902,Onslow,NC,969,872,97
37133001000,Onslow,NC,337,280,57
37133001101,Onslow,NC,2164,1921,243
37133001102,Onslow,NC,2203,1783,420
37133001201,Onslow,NC,1206,1138,68
37133001202,Onslow,NC,3295,3014,281
37133001301,Onslow,NC,2271,1926,345
37133001302,Onslow,NC,1240,1138,102
37133001303,Onslow,NC,1121,1009,112
37133001304,Onslow,NC,3596,3103,493
37133001400,Onslow,NC,1843,1714,129
37133001500,Onslow,NC,1181,1049,132
37133001700,Onslow,NC,1187,1022,165
37133001800,Onslow,NC,813,645,168
37133002100,Onslow,NC,2551,2276,275
37133002201,Onslow,NC,2115,1933,182
37133002202,Onslow,NC,2135,1825,310
37133002300,Onslow,NC,1843,1632,211
37133002400,Onslow,NC,3299,2824,475
37133002500,Onslow,NC,1508,1255,253
37133002600,Onslow,NC,1806,1314,492
37133002801,Onslow,NC,1134,857,277
37133002802,Onslow,NC,1043,884,159
37133002803,Onslow,NC,2686,2322,364
37133990100,Onslow,NC,0,0,0
37135010701,Orange,NC,860,813,47
37135010705,Orange,NC,2385,2232,153
37135010706,Orange,NC,1331,1291,40
37135010707,Orange,NC,1998,1850,148
37135010708,Orange,NC,1291,1225,66
37135010709,Orange,NC,1087,991,96
37135010710,Orange,NC,1591,1518,73
37135010802,Orange,NC,2085,1969,116
37135010803,Orange,NC,1364,1270,94
37135010804,Orange,NC,887,806,81
37135010902,Orange,NC,2611,2479,132
37135010903,Orange,NC,1055,1004,51
37135010904,Orange,NC,1414,1348,66
37135011001,Orange,NC,1959,1833,126
37135011002,Orange,NC,2046,1861,185
37135011103,Orange,NC,1719,1586,133
37135011104,Orange,NC,616,585,31
37135011105,Orange,NC,1476,1402,74
37135011106,Orange,NC,1088,1029,59
37135011107,Orange,NC,1719,1605,114
37135011204,Orange,NC,1425,1297,128
37135011206,Orange,NC,1828,1730,98
37135011207,Orange,NC,2323,2000,323
37135011208,Orange,NC,1816,1734,82
37135011209,Orange,NC,1314,1218,96
37135011210,Orange,NC,1502,1391,111
37135011211,Orange,NC,1064,975,89
37135011300,Orange,NC,1262,1188,74
37135011400,Orange,NC,1770,1579,191
37135011500,Orange,NC,938,844,94
37135011601,Orange,NC,29,16,13
37135011602,Orange,NC,258,206,52
37135011700,Orange,NC,1946,1843,103
37135011800,Orange,NC,1486,1343,143
37135011902,Orange,NC,2069,1946,123
37135011903,Orange,NC,960,911,49
37135011904,Orange,NC,1425,1373,52
37135012101,Orange,NC,1714,1631,83
37135012102,Orange,NC,586,544,42
37135012103,Orange,NC,1275,1184,91
37135012201,Orange,NC,1381,1265,116
37135012202,Orange,NC,2258,2144,114
37137950101,Pamlico,NC,1468,1232,236
37137950103,Pamlico,NC,922,761,161
37137950104,Pamlico,NC,794,495,299
37137950202,Pamlico,NC,1535,1059,476
37137950203,Pamlico,NC,1320,803,517
37137950204,Pamlico,NC,1079,843,236
37137990100,Pamlico,NC,0,0,0
37139960100,Pasquotank,NC,855,631,224
37139960200,Pasquotank,NC,1839,1587,252
37139960300,Pasquotank,NC,1361,1184,177
37139960400,Pasquotank,NC,2138,1854,284
37139960501,Pasquotank,NC,1361,1241,120
37139960502,Pasquotank,NC,1926,1792,134
37139960503,Pasquotank,NC,1067,999,68
37139960600,Pasquotank,NC,3036,2841,195
37139960701,Pasquotank,NC,2401,2222,179
37139960702,Pasquotank,NC,1426,1265,161
37141920104,Pender,NC,2573,1765,808
37141920105,Pender,NC,998,637,361
37141920106,Pender,NC,3633,853,2780
37141920201,Pender,NC,3330,2965,365
37141920202,Pender,NC,3601,3313,288
37141920203,Pender,NC,2510,2189,321
37141920204,Pender,NC,1003,749,254
37141920300,Pender,NC,1864,1561,303
37141920401,Pender,NC,1065,907,158
37141920402,Pender,NC,1117,1002,115
37141920403,Pender,NC,1534,1250,284
37141920501,Pender,NC,2028,1679,349
37141920502,Pender,NC,850,668,182
37141920601,Pender,NC,1186,1036,150
37141920602,Pender,NC,2635,2388,247
37141990100,Pender,NC,0,0,0
37143920101,Perquimans,NC,1689,1447,242
37143920102,Perquimans,NC,1551,1307,244
37143920201,Perquimans,NC,1333,1094,239
37143920202,Perquimans,NC,2293,1718,575
37145920100,Person,NC,3087,2770,317
37145920200,Person,NC,3442,2661,781
37145920300,Person,NC,2875,2588,287
37145920400,Person,NC,1358,1203,155
37145920500,Person,NC,3069,2881,188
37145920601,Person,NC,2350,2151,199
37145920602,Person,NC,2103,1922,181
37147000101,Pitt,NC,2095,1209,886
37147000102,Pitt,NC,1610,884,726
37147000201,Pitt,NC,3250,2128,1122
37147000202,Pitt,NC,1408,1222,186
37147000301,Pitt,NC,1355,1286,69
37147000303,Pitt,NC,1762,1143,619
37147000304,Pitt,NC,2406,2252,154
37147000400,Pitt,NC,1001,780,221
37147000501,Pitt,NC,3122,2878,244
37147000503,Pitt,NC,2464,2260,204
37147000504,Pitt,NC,1612,1295,317
37147000602,Pitt,NC,2581,2289,292
37147000604,Pitt,NC,2940,2505,435
37147000605,Pitt,NC,2519,2309,210
37147000606,Pitt,NC,1681,1581,100
37147000607,Pitt,NC,3483,3285,198
37147000701,Pitt,NC,1967,1603,364
37147000702,Pitt,NC,1174,1034,140
37147000800,Pitt,NC,1187,1050,137
37147000901,Pitt,NC,1968,1599,369
37147000902,Pitt,NC,1220,1069,151
37147001001,Pitt,NC,895,805,90
37147001002,Pitt,NC,2622,2462,160
37147001003,Pitt,NC,2361,2216,145
37147001100,Pitt,NC,2127,1928,199
37147001200,Pitt,NC,2912,2504,408
37147001301,Pitt,NC,1837,1719,118
37147001302,Pitt,NC,2426,2291,135
37147001304,Pitt,NC,1652,1589,63
37147001305,Pitt,NC,2024,1927,97
37147001402,Pitt,NC,1210,1058,152
37147001403,Pitt,NC,1397,1304,93
37147001404,Pitt,NC,871,712,159
37147001500,Pitt,NC,1388,1235,153
37147001601,Pitt,NC,1640,1558,82
37147001602,Pitt,NC,2248,2093,155
37147001700,Pitt,NC,1692,1582,110
37147001800,Pitt,NC,2755,2369,386
37147001900,Pitt,NC,1270,1103,167
37147002002,Pitt,NC,2207,1943,264
37147002003,Pitt,NC,1459,1310,149
37147002004,Pitt,NC,717,647,70
37149920101,Polk,NC,1507,1262,245
37149920103,Polk,NC,1518,1301,217
37149920104,Polk,NC,1495,1298,197
37149920201,Polk,NC,1668,1149,519
37149920202,Polk,NC,1125,898,227
37149920301,Polk,NC,557,469,88
37149920303,Polk,NC,1177,804,373
37149920304,Polk,NC,1728,1357,371
37151030100,Randolph,NC,2275,2067,208
37151030201,Randolph,NC,1592,1463,129
37151030202,Randolph,NC,2038,1918,120
37151030301,Randolph,NC,2782,2575,207
37151030302,Randolph,NC,1157,1026,131
37151030400,Randolph,NC,1835,1669,166
37151030502,Randolph,NC,1916,1769,147
37151030503,Randolph,NC,2429,2279,150
37151030504,Randolph,NC,2511,2330,181
37151030600,Randolph,NC,2950,2768,182
37151030700,Randolph,NC,2637,2402,235
37151030803,Randolph,NC,1667,1518,149
37151030804,Randolph,NC,1038,964,74
37151030805,Randolph,NC,1710,1578,132
37151030806,Randolph,NC,1113,1029,84
37151030900,Randolph,NC,1690,1473,217
37151031001,Randolph,NC,1218,1078,140
37151031002,Randolph,NC,1913,1768,145
37151031101,Randolph,NC,1482,1347,135
37151031102,Randolph,NC,1029,909,120
37151031200,Randolph,NC,2353,2131,222
37151031303,Randolph,NC,1828,1727,101
37151031304,Randolph,NC,2129,1992,137
37151031305,Randolph,NC,1643,1518,125
37151031307,Randolph,NC,1727,1652,75
37151031308,Randolph,NC,1131,1059,72
37151031401,Randolph,NC,2386,2246,140
37151031402,Randolph,NC,1518,1457,61
37151031501,Randolph,NC,2513,2385,128
37151031503,Randolph,NC,1504,1414,90
37151031504,Randolph,NC,2189,2116,73
37151031505,Randolph,NC,1490,1378,112
37151031601,Randolph,NC,1930,1800,130
37151031602,Randolph,NC,701,665,36
37153970100,Richmond,NC,1186,1051,135
37153970200,Richmond,NC,2083,1800,283
37153970300,Richmond,NC,2097,1820,277
37153970400,Richmond,NC,1854,1700,154
37153970500,Richmond,NC,1105,931,174
37153970600,Richmond,NC,1894,1762,132
37153970700,Richmond,NC,1318,1134,184
37153970800,Richmond,NC,2216,2004,212
37153970900,Richmond,NC,2238,2045,193
37153971000,Richmond,NC,1794,1570,224
37153971100,Richmond,NC,1820,1637,183
37155960101,Robeson,NC,1445,1333,112
37155960102,Robeson,NC,1989,1819,170
37155960202,Robeson,NC,1476,1340,136
37155960203,Robeson,NC,1344,1209,135
37155960204,Robeson,NC,808,732,76
37155960301,Robeson,NC,1505,1299,206
37155960302,Robeson,NC,990,913,77
37155960402,Robeson,NC,1270,1201,69
37155960403,Robeson,NC,1163,1064,99
37155960404,Robeson,NC,1224,1161,63
37155960501,Robeson,NC,1194,1113,81
37155960502,Robeson,NC,1677,1556,121
37155960503,Robeson,NC,725,659,66
37155960601,Robeson,NC,1527,1454,73
37155960602,Robeson,NC,590,494,96
37155960701,Robeson,NC,1860,1707,153
37155960702,Robeson,NC,1076,982,94
37155960801,Robeson,NC,1345,957,388
37155960802,Robeson,NC,677,435,242
37155960900,Robeson,NC,917,810,107
37155961000,Robeson,NC,943,766,177
37155961100,Robeson,NC,749,662,87
37155961200,Robeson,NC,1270,1132,138
37155961301,Robeson,NC,1824,1702,122
37155961302,Robeson,NC,2186,2003,183
37155961400,Robeson,NC,1544,1434,110
37155961500,Robeson,NC,2122,1937,185
37155961601,Robeson,NC,1437,1278,159
37155961602,Robeson,NC,1427,1259,168
37155961700,Robeson,NC,2126,1865,261
37155961801,Robeson,NC,1714,1568,146
37155961802,Robeson,NC,1881,1729,152
37155961900,Robeson,NC,1818,1585,233
37155962001,Robeson,NC,1471,1214,257
37155962002,Robeson,NC,1112,1030,82
37157040101,Rockingham,NC,1885,1700,185
37157040102,Rockingham,NC,1197,1062,135
37157040200,Rockingham,NC,1842,1562,280
37157040300,Rockingham,NC,2011,1850,161
37157040400,Rockingham,NC,2858,2412,446
37157040501,Rockingham,NC,1829,1566,263
37157040502,Rockingham,NC,1416,1243,173
37157040601,Rockingham,NC,1752,1591,161
37157040602,Rockingham,NC,1946,1744,202
37157040700,Rockingham,NC,2092,1846,246
37157040800,Rockingham,NC,877,779,98
37157040900,Rockingham,NC,1284,1145,139
37157041001,Rockingham,NC,2888,2626,262
37157041002,Rockingham,NC,2529,2335,194
37157041100,Rockingham,NC,2971,2714,257
37157041200,Rockingham,NC,2556,2151,405
37157041300,Rockingham,NC,2916,2565,351
37157041400,Rockingham,NC,1450,1303,147
37157041501,Rockingham,NC,634,583,51
37157041502,Rockingham,NC,2997,2743,254
37157041601,Rockingham,NC,1446,1311,135
37157041602,Rockingham,NC,2055,1909,146
37159050201,Rowan,NC,1901,1733,168
37159050202,Rowan,NC,2435,2242,193
37159050300,Rowan,NC,1804,1624,180
37159050400,Rowan,NC,1185,967,218
37159050500,Rowan,NC,1327,1196,131
37159050700,Rowan,NC,1448,1256,192
37159050800,Rowan,NC,1417,1204,213
37159050901,Rowan,NC,2146,1772,374
37159050903,Rowan,NC,2704,2497,207
37159050904,Rowan,NC,1358,1073,285
37159051001,Rowan,NC,3226,2975,251
37159051002,Rowan,NC,2543,2367,176
37159051101,Rowan,NC,2947,2756,191
37159051102,Rowan,NC,1610,1482,128
37159051201,Rowan,NC,2326,2180,146
37159051202,Rowan,NC,1574,1463,111
37159051204,Rowan,NC,1781,1678,103
37159051301,Rowan,NC,1327,1212,115
37159051302,Rowan,NC,2377,2178,199
37159051303,Rowan,NC,2888,2629,259
37159051400,Rowan,NC,3198,2944,254
37159051501,Rowan,NC,1730,1615,115
37159051502,Rowan,NC,1378,1259,119
37159051600,Rowan,NC,3182,2868,314
37159051700,Rowan,NC,3433,3188,245
37159051801,Rowan,NC,1871,1711,160
37159051802,Rowan,NC,2012,1865,147
37159051901,Rowan,NC,2042,1906,136
37159051903,Rowan,NC,1506,1364,142
37159051904,Rowan,NC,1377,1237,140
37159052000,Rowan,NC,1147,992,155
37161960101,Rutherford,NC,784,621,163
37161960102,Rutherford,NC,1143,942,201
37161960103,Rutherford,NC,1107,967,140
37161960201,Rutherford,NC,2145,1796,349
37161960202,Rutherford,NC,592,518,74
37161960203,Rutherford,NC,678,558,120
37161960301,Rutherford,NC,1731,735,996
37161960302,Rutherford,NC,1828,714,1114
37161960400,Rutherford,NC,1562,1399,163
37161960501,Rutherford,NC,1202,1049,153
37161960502,Rutherford,NC,1336,1107,229
37161960503,Rutherford,NC,824,748,76
37161960600,Rutherford,NC,1903,1667,236
37161960700,Rutherford,NC,2074,1836,238
37161960800,Rutherford,NC,2195,1923,272
37161960900,Rutherford,NC,2379,2159,220
37161961001,Rutherford,NC,1797,1591,206
37161961002,Rutherford,NC,1419,1237,182
37161961102,Rutherford,NC,1374,1245,129
37161961103,Rutherford,NC,1044,893,151
37161961104,Rutherford,NC,1351,1190,161
37161961200,Rutherford,NC,1976,1757,219
37163970101,Sampson,NC,756,663,93
37163970102,Sampson,NC,1861,1659,202
37163970201,Sampson,NC,516,466,50
37163970202,Sampson,NC,2094,1880,214
37163970302,Sampson,NC,2048,1843,205
37163970303,Sampson,NC,854,808,46
37163970304,Sampson,NC,1665,1567,98
37163970401,Sampson,NC,886,767,119
37163970402,Sampson,NC,1312,1113,199
37163970501,Sampson,NC,536,478,58
37163970502,Sampson,NC,1836,1626,210
37163970600,Sampson,NC,1975,1759,216
37163970701,Sampson,NC,867,798,69
37163970702,Sampson,NC,1857,1699,158
37163970801,Sampson,NC,966,845,121
37163970802,Sampson,NC,1808,1647,161
37163970900,Sampson,NC,1372,1147,225
37163971001,Sampson,NC,1135,925,210
37163971002,Sampson,NC,686,508,178
37163971003,Sampson,NC,451,364,87
37165010101,Scotland,NC,1534,1447,87
37165010102,Scotland,NC,2484,2288,196
37165010200,Scotland,NC,1697,1446,251
37165010300,Scotland,NC,1718,1456,262
37165010400,Scotland,NC,1159,1086,73
37165010501,Scotland,NC,1230,1091,139
37165010502,Scotland,NC,1602,1431,171
37165010601,Scotland,NC,1477,1306,171
37165010602,Scotland,NC,1447,1319,128
37167930101,Stanly,NC,1703,1548,155
37167930102,Stanly,NC,1693,1476,217
37167930200,Stanly,NC,1896,1680,216
37167930300,Stanly,NC,1672,1540,132
37167930500,Stanly,NC,1582,1385,197
37167930700,Stanly,NC,1975,1826,149
37167930801,Stanly,NC,2519,2379,140
37167930802,Stanly,NC,1905,1813,92
37167930901,Stanly,NC,1174,1055,119
37167930902,Stanly,NC,1435,1359,76
37167931001,Stanly,NC,1017,914,103
37167931002,Stanly,NC,1594,1410,184
37167931101,Stanly,NC,1190,861,329
37167931102,Stanly,NC,1716,1385,331
37167931202,Stanly,NC,1482,1335,147
37167931203,Stanly,NC,1302,1120,182
37167931204,Stanly,NC,1830,1656,174
37169070101,Stokes,NC,1729,1484,245
37169070102,Stokes,NC,1346,1127,219
37169070200,Stokes,NC,1668,1405,263
37169070301,Stokes,NC,1265,1008,257
37169070302,Stokes,NC,999,899,100
37169070400,Stokes,NC,2258,2044,214
37169070503,Stokes,NC,2481,2342,139
37169070504,Stokes,NC,1419,1294,125
37169070505,Stokes,NC,1685,1552,133
37169070506,Stokes,NC,1424,1323,101
37169070600,Stokes,NC,2283,2049,234
37169070701,Stokes,NC,1371,1263,108
37169070702,Stokes,NC,1232,1103,129
37171930101,Surry,NC,942,782,160
37171930102,Surry,NC,2121,1918,203
37171930201,Surry,NC,1529,1318,211
37171930202,Surry,NC,1527,1322,205
37171930301,Surry,NC,979,874,105
37171930302,Surry,NC,1845,1690,155
37171930400,Surry,NC,1255,1116,139
37171930501,Surry,NC,1253,1157,96
37171930502,Surry,NC,1704,1523,181
37171930600,Surry,NC,1662,1537,125
37171930700,Surry,NC,1867,1692,175
37171930802,Surry,NC,1537,1334,203
37171930803,Surry,NC,1276,970,306
37171930804,Surry,NC,1153,1021,132
37171930901,Surry,NC,2176,1870,306
37171930902,Surry,NC,762,716,46
37171931001,Surry,NC,1061,945,116
37171931002,Surry,NC,2043,1896,147
37171931003,Surry,NC,1233,1102,131
37171931101,Surry,NC,1256,1123,133
37171931102,Surry,NC,1666,1437,229
37171931103,Surry,NC,823,716,107
37171931200,Surry,NC,1766,1600,166
37173940100,Swain,NC,2168,1789,379
37173960200,Swain,NC,1825,1281,544
37173960301,Swain,NC,2219,1337,882
37173960302,Swain,NC,2104,1321,783
37173980200,Swain,NC,25,6,19
37175960100,Transylvania,NC,1992,1781,211
37175960201,Transylvania,NC,933,819,114
37175960202,Transylvania,NC,1414,1211,203
37175960301,Transylvania,NC,1786,1569,217
37175960302,Transylvania,NC,1784,1575,209
37175960401,Transylvania,NC,2256,1861,395
37175960403,Transylvania,NC,2243,1333,910
37175960404,Transylvania,NC,1185,862,323
37175960501,Transylvania,NC,1523,1176,347
37175960502,Transylvania,NC,1315,1099,216
37175960601,Transylvania,NC,1073,510,563
37175960602,Transylvania,NC,1521,589,932
37177960100,Tyrrell,NC,1999,1444,555
37179020100,Union,NC,2684,2537,147
37179020203,Union,NC,1537,1469,68
37179020204,Union,NC,1582,1506,76
37179020205,Union,NC,1252,1193,59
37179020206,Union,NC,1520,1451,69
37179020305,Union,NC,2374,2321,53
37179020307,Union,NC,2412,2336,76
37179020308,Union,NC,2242,2129,113
37179020309,Union,NC,888,867,21
37179020310,Union,NC,2163,2123,40
37179020312,Union,NC,1731,1653,78
37179020313,Union,NC,975,923,52
37179020314,Union,NC,2226,2180,46
37179020315,Union,NC,1731,1688,43
37179020316,Union,NC,1871,1778,93
37179020317,Union,NC,2126,2070,56
37179020318,Union,NC,1444,1400,44
37179020319,Union,NC,1144,1125,19
37179020320,Union,NC,1017,989,28
37179020321,Union,NC,1643,1574,69
37179020401,Union,NC,2472,2351,121
37179020403,Union,NC,1775,1668,107
37179020405,Union,NC,962,890,72
37179020406,Union,NC,1603,1433,170
37179020501,Union,NC,2016,1911,105
37179020502,Union,NC,1531,1470,61
37179020601,Union,NC,1752,1672,80
37179020602,Union,NC,1783,1657,126
37179020701,Union,NC,1614,1492,122
37179020702,Union,NC,1554,1462,92
37179020800,Union,NC,2069,1892,177
37179020901,Union,NC,2085,1947,138
37179020902,Union,NC,2397,2238,159
37179021004,Union,NC,2179,2144,35
37179021005,Union,NC,1968,1851,117
37179021006,Union,NC,1748,1694,54
37179021007,Union,NC,2059,2010,49
37179021009,Union,NC,1245,1235,10
37179021012,Union,NC,1732,1675,57
37179021013,Union,NC,2974,2865,109
37179021014,Union,NC,1083,1038,45
37179021015,Union,NC,1935,1801,134
37179021016,Union,NC,1560,1524,36
37179021017,Union,NC,1645,1595,50
37179021018,Union,NC,1473,1433,40
37179021019,Union,NC,1674,1618,56
37179021020,Union,NC,1525,1498,27
37179021021,Union,NC,813,791,22
37181960100,Vance,NC,1928,1613,315
37181960200,Vance,NC,2187,1643,544
37181960300,Vance,NC,2232,2068,164
37181960400,Vance,NC,1944,1829,115
37181960500,Vance,NC,2205,1931,274
37181960600,Vance,NC,621,539,82
37181960700,Vance,NC,1699,1444,255
37181960800,Vance,NC,850,752,98
37181960901,Vance,NC,1128,1039,89
37181960902,Vance,NC,690,652,38
37181960903,Vance,NC,1425,1314,111
37181961000,Vance,NC,2367,2214,153
37183050100,Wake,NC,3745,3089,656
37183050300,Wake,NC,2580,2400,180
37183050400,Wake,NC,826,802,24
37183050500,Wake,NC,1844,1720,124
37183050600,Wake,NC,1301,1175,126
37183050700,Wake,NC,1553,1401,152
37183050800,Wake,NC,1026,849,177
37183050900,Wake,NC,1051,965,86
37183051000,Wake,NC,1779,1588,191
37183051101,Wake,NC,840,755,85
37183051102,Wake,NC,78,67,11
37183051200,Wake,NC,2746,2474,272
37183051400,Wake,NC,2805,2384,421
37183051501,Wake,NC,1488,1436,52
37183051502,Wake,NC,1359,1205,154
37183051600,Wake,NC,2175,2025,150
37183051700,Wake,NC,1810,1637,173
37183051800,Wake,NC,2481,2365,116
37183051900,Wake,NC,2120,2008,112
37183052001,Wake,NC,1630,1464,166
37183052002,Wake,NC,1886,1769,117
37183052101,Wake,NC,3218,3070,148
37183052102,Wake,NC,2080,1993,87
37183052303,Wake,NC,1495,1396,99
37183052304,Wake,NC,1206,1110,96
37183052305,Wake,NC,1299,1052,247
37183052306,Wake,NC,683,645,38
37183052307,Wake,NC,2624,2418,206
37183052401,Wake,NC,3286,3115,171
37183052404,Wake,NC,1715,1645,70
37183052407,Wake,NC,2189,2062,127
37183052408,Wake,NC,1375,1242,133
37183052409,Wake,NC,1866,1723,143
37183052410,Wake,NC,810,772,38
37183052411,Wake,NC,3184,2942,242
37183052504,Wake,NC,4152,3818,334
37183052505,Wake,NC,2705,2420,285
37183052506,Wake,NC,1349,1288,61
37183052507,Wake,NC,1327,1251,76
37183052508,Wake,NC,1711,1610,101
37183052509,Wake,NC,2007,1920,87
37183052601,Wake,NC,1448,1353,95
37183052602,Wake,NC,3076,2784,292
37183052603,Wake,NC,1855,1738,117
37183052701,Wake,NC,2859,2729,130
37183052704,Wake,NC,2758,2608,150
37183052705,Wake,NC,2815,2650,165
37183052706,Wake,NC,1918,1850,68
37183052707,Wake,NC,2772,2691,81
37183052801,Wake,NC,2582,2500,82
37183052802,Wake,NC,2623,2492,131
37183052807,Wake,NC,2686,2506,180
37183052809,Wake,NC,1019,974,45
37183052810,Wake,NC,2694,2629,65
37183052811,Wake,NC,3022,2931,91
37183052812,Wake,NC,1877,1808,69
37183052813,Wake,NC,1649,1374,275
37183052814,Wake,NC,2012,1866,146
37183052815,Wake,NC,1946,1808,138
37183052816,Wake,NC,1912,1850,62
37183052901,Wake,NC,1093,1025,68
37183052902,Wake,NC,2256,2174,82
37183052903,Wake,NC,1230,1194,36
37183052905,Wake,NC,1166,1144,22
37183052906,Wake,NC,1972,1917,55
37183053003,Wake,NC,3154,2929,225
37183053004,Wake,NC,1373,1316,57
37183053005,Wake,NC,1837,1788,49
37183053006,Wake,NC,1157,1120,37
37183053007,Wake,NC,1365,1313,52
37183053009,Wake,NC,3703,3512,191
37183053010,Wake,NC,1829,1764,65
37183053011,Wake,NC,2188,2053,135
37183053105,Wake,NC,2567,2270,297
37183053106,Wake,NC,1521,1398,123
37183053109,Wake,NC,3786,3591,195
37183053110,Wake,NC,2357,2262,95
37183053111,Wake,NC,2453,2358,95
37183053112,Wake,NC,2640,2514,126
37183053113,Wake,NC,2199,2020,179
37183053114,Wake,NC,2545,2450,95
37183053115,Wake,NC,990,950,40
37183053202,Wake,NC,1518,1472,46
37183053203,Wake,NC,3578,3453,125
37183053204,Wake,NC,1950,1892,58
37183053205,Wake,NC,2193,2080,113
37183053206,Wake,NC,2049,1866,183
37183053208,Wake,NC,3989,3643,346
37183053209,Wake,NC,1027,967,60
37183053210,Wake,NC,1816,1756,60
37183053211,Wake,NC,2600,2521,79
37183053405,Wake,NC,2375,2219,156
37183053408,Wake,NC,1347,1324,23
37183053409,Wake,NC,2247,2196,51
37183053410,Wake,NC,2091,2039,52
37183053411,Wake,NC,4648,4498,150
37183053415,Wake,NC,1770,1694,76
37183053417,Wake,NC,1913,1825,88
37183053419,Wake,NC,1043,1020,23
37183053421,Wake,NC,2122,2036,86
37183053422,Wake,NC,876,859,17
37183053423,Wake,NC,989,962,27
37183053424,Wake,NC,1800,1737,63
37183053425,Wake,NC,1184,1112,72
37183053426,Wake,NC,2686,2394,292
37183053427,Wake,NC,2125,1975,150
37183053428,Wake,NC,4422,4143,279
37183053429,Wake,NC,1376,1320,56
37183053430,Wake,NC,1676,1607,69
37183053431,Wake,NC,2010,1948,62
37183053432,Wake,NC,1207,1135,72
37183053433,Wake,NC,1563,1528,35
37183053434,Wake,NC,1707,1648,59
37183053435,Wake,NC,1893,1490,403
37183053436,Wake,NC,1375,1287,88
37183053505,Wake,NC,1572,1519,53
37183053506,Wake,NC,2523,2428,95
37183053507,Wake,NC,2024,1936,88
37183053509,Wake,NC,1929,1876,53
37183053512,Wake,NC,3679,3477,202
37183053513,Wake,NC,1952,1865,87
37183053516,Wake,NC,1645,1523,122
37183053517,Wake,NC,1765,1676,89
37183053518,Wake,NC,1590,1533,57
37183053519,Wake,NC,2014,1848,166
37183053520,Wake,NC,2630,2506,124
37183053521,Wake,NC,1397,1351,46
37183053522,Wake,NC,3838,3558,280
37183053523,Wake,NC,2379,2279,100
37183053524,Wake,NC,1766,1710,56
37183053525,Wake,NC,1174,1132,42
37183053603,Wake,NC,1664,1623,41
37183053604,Wake,NC,1445,1417,28
37183053608,Wake,NC,2618,2547,71
37183053609,Wake,NC,839,758,81
37183053611,Wake,NC,2516,2334,182
37183053612,Wake,NC,1380,1271,109
37183053613,Wake,NC,2308,2211,97
37183053614,Wake,NC,1221,1136,85
37183053615,Wake,NC,2860,2672,188
37183053616,Wake,NC,2509,2387,122
37183053617,Wake,NC,4118,3637,481
37183053618,Wake,NC,2112,2013,99
37183053619,Wake,NC,290,285,5
37183053620,Wake,NC,2179,2124,55
37183053711,Wake,NC,2267,2216,51
37183053712,Wake,NC,1147,1128,19
37183053713,Wake,NC,2299,2130,169
37183053714,Wake,NC,2449,2348,101
37183053715,Wake,NC,1546,1491,55
37183053716,Wake,NC,2214,2104,110
37183053717,Wake,NC,2589,2409,180
37183053718,Wake,NC,1198,1184,14
37183053719,Wake,NC,1393,1376,17
37183053720,Wake,NC,1518,1483,35
37183053721,Wake,NC,1410,1391,19
37183053722,Wake,NC,2531,2429,102
37183053723,Wake,NC,1794,1690,104
37183053724,Wake,NC,2703,2623,80
37183053725,Wake,NC,2617,2541,76
37183053726,Wake,NC,1663,1598,65
37183053727,Wake,NC,2475,2386,89
37183053728,Wake,NC,1700,1600,100
37183053729,Wake,NC,2105,2028,77
37183053730,Wake,NC,1380,1309,71
37183053803,Wake,NC,1391,1333,58
37183053804,Wake,NC,1460,1381,79
37183053805,Wake,NC,733,712,21
37183053806,Wake,NC,1320,1272,48
37183053807,Wake,NC,1651,1583,68
37183053808,Wake,NC,2039,1996,43
37183053901,Wake,NC,1664,1549,115
37183053902,Wake,NC,2200,2099,101
37183054001,Wake,NC,2997,2723,274
37183054004,Wake,NC,2656,2526,130
37183054006,Wake,NC,1335,1278,57
37183054007,Wake,NC,2093,1989,104
37183054008,Wake,NC,2886,2651,235
37183054011,Wake,NC,1100,1077,23
37183054012,Wake,NC,1563,1496,67
37183054015,Wake,NC,1931,1819,112
37183054016,Wake,NC,2608,2535,73
37183054017,Wake,NC,1327,1259,68
37183054018,Wake,NC,2050,1868,182
37183054019,Wake,NC,2271,2064,207
37183054020,Wake,NC,2060,1990,70
37183054021,Wake,NC,1087,1062,25
37183054022,Wake,NC,2313,2225,88
37183054023,Wake,NC,2957,2860,97
37183054106,Wake,NC,3065,2929,136
37183054108,Wake,NC,2948,2814,134
37183054109,Wake,NC,1768,1707,61
37183054111,Wake,NC,990,956,34
37183054112,Wake,NC,1475,1408,67
37183054113,Wake,NC,2127,2013,114
37183054114,Wake,NC,2803,2712,91
37183054115,Wake,NC,3804,3651,153
37183054116,Wake,NC,2428,2263,165
37183054117,Wake,NC,2154,2116,38
37183054118,Wake,NC,2184,2117,67
37183054119,Wake,NC,3062,2943,119
37183054120,Wake,NC,581,571,10
37183054121,Wake,NC,3113,3038,75
37183054203,Wake,NC,1362,1323,39
37183054204,Wake,NC,1890,1789,101
37183054206,Wake,NC,2897,2708,189
37183054212,Wake,NC,2787,2585,202
37183054213,Wake,NC,1753,1659,94
37183054214,Wake,NC,831,804,27
37183054215,Wake,NC,1684,1647,37
37183054216,Wake,NC,2024,1956,68
37183054217,Wake,NC,1493,1444,49
37183054218,Wake,NC,3096,3008,88
37183054219,Wake,NC,1607,1520,87
37183054220,Wake,NC,2713,2626,87
37183054221,Wake,NC,2560,2444,116
37183054222,Wake,NC,2816,2690,126
37183054223,Wake,NC,1195,1015,180
37183054224,Wake,NC,1903,1778,125
37183054303,Wake,NC,1131,1044,87
37183054304,Wake,NC,2098,1988,110
37183054305,Wake,NC,1423,1352,71
37183054306,Wake,NC,1415,1334,81
37183054402,Wake,NC,3297,3112,185
37183054403,Wake,NC,1507,1440,67
37183054404,Wake,NC,2603,2488,115
37183054501,Wake,NC,2586,2491,95
37183054502,Wake,NC,1308,1196,112
37183980100,Wake,NC,2,2,0
37183980200,Wake,NC,0,0,0
37185950101,Warren,NC,2517,1109,1408
37185950102,Warren,NC,1316,649,667
37185950103,Warren,NC,1243,1034,209
37185950201,Warren,NC,1776,1532,244
37185950202,Warren,NC,893,685,208
37185950300,Warren,NC,1952,1558,394
37185950400,Warren,NC,1612,1327,285
37187950100,Washington,NC,2371,1846,525
37187950201,Washington,NC,1422,1138,284
37187950202,Washington,NC,1499,1294,205
37187950300,Washington,NC,747,593,154
37189920100,Watauga,NC,2464,1898,566
37189920200,Watauga,NC,2061,1650,411
37189920300,Watauga,NC,1381,1046,335
37189920400,Watauga,NC,4628,3818,810
37189920500,Watauga,NC,1256,1088,168
37189920601,Watauga,NC,2915,2495,420
37189920602,Watauga,NC,2007,1097,910
37189920701,Watauga,NC,1027,812,215
37189920702,Watauga,NC,2169,1262,907
37189920703,Watauga,NC,2937,2457,480
37189920800,Watauga,NC,3605,1351,2254
37189920900,Watauga,NC,4132,2081,2051
37189921000,Watauga,NC,2055,358,1697
37191000102,Wayne,NC,2654,2459,195
37191000103,Wayne,NC,1100,977,123
37191000104,Wayne,NC,1988,1832,156
37191000200,Wayne,NC,1411,1210,201
37191000302,Wayne,NC,2513,2267,246
37191000303,Wayne,NC,2855,2634,221
37191000304,Wayne,NC,2231,1999,232
37191000401,Wayne,NC,2480,2297,183
37191000402,Wayne,NC,1912,1703,209
37191000500,Wayne,NC,702,662,40
37191000601,Wayne,NC,1871,1644,227
37191000603,Wayne,NC,2076,1720,356
37191000604,Wayne,NC,1307,1061,246
37191000700,Wayne,NC,1243,1012,231
37191000800,Wayne,NC,952,795,157
37191000901,Wayne,NC,2035,1758,277
37191000902,Wayne,NC,2365,2087,278
37191001000,Wayne,NC,1840,1561,279
37191001102,Wayne,NC,1199,1090,109
37191001103,Wayne,NC,1211,1078,133
37191001104,Wayne,NC,1513,1366,147
37191001200,Wayne,NC,2047,1805,242
37191001301,Wayne,NC,2842,2555,287
37191001302,Wayne,NC,2011,1748,263
37191001401,Wayne,NC,1845,1561,284
37191001402,Wayne,NC,1273,1054,219
37191001500,Wayne,NC,1290,968,322
37191001800,Wayne,NC,1204,921,283
37191001900,Wayne,NC,1985,1724,261
37191002000,Wayne,NC,596,449,147
37193960101,Wilkes,NC,1525,1348,177
37193960102,Wilkes,NC,1637,1418,219
37193960200,Wilkes,NC,1721,1499,222
37193960300,Wilkes,NC,2696,2457,239
37193960401,Wilkes,NC,1612,1365,247
37193960402,Wilkes,NC,1680,1527,153
37193960500,Wilkes,NC,1505,1350,155
37193960600,Wilkes,NC,1268,1124,144
37193960700,Wilkes,NC,1631,1456,175
37193960801,Wilkes,NC,1798,1639,159
37193960802,Wilkes,NC,2008,1845,163
37193960901,Wilkes,NC,1544,1051,493
37193960902,Wilkes,NC,1231,989,242
37193961001,Wilkes,NC,2322,1983,339
37193961002,Wilkes,NC,2311,2068,243
37193961100,Wilkes,NC,1825,1622,203
37193961201,Wilkes,NC,1698,1517,181
37193961202,Wilkes,NC,1533,1354,179
37195000100,Wilson,NC,1528,1171,357
37195000200,Wilson,NC,517,377,140
37195000300,Wilson,NC,1032,886,146
37195000401,Wilson,NC,2215,2054,161
37195000402,Wilson,NC,1710,1591,119
37195000501,Wilson,NC,1655,1513,142
37195000502,Wilson,NC,2181,2067,114
37195000601,Wilson,NC,1812,1586,226
37195000602,Wilson,NC,1772,1684,88
37195000701,Wilson,NC,1036,938,98
37195000702,Wilson,NC,1400,1098,302
37195000801,Wilson,NC,893,690,203
37195000802,Wilson,NC,1464,1282,182
37195000900,Wilson,NC,1560,1396,164
37195001000,Wilson,NC,789,708,81
37195001100,Wilson,NC,729,615,114
37195001200,Wilson,NC,1596,1448,148
37195001301,Wilson,NC,1266,1152,114
37195001302,Wilson,NC,1171,1061,110
37195001401,Wilson,NC,1388,1324,64
37195001402,Wilson,NC,2856,2541,315
37195001501,Wilson,NC,986,874,112
37195001502,Wilson,NC,1495,1353,142
37195001600,Wilson,NC,1397,1233,164
37195001700,Wilson,NC,1804,1580,224
37197050101,Yadkin,NC,2524,2262,262
37197050102,Yadkin,NC,1850,1660,190
37197050200,Yadkin,NC,2076,1858,218
37197050300,Yadkin,NC,2722,2452,270
37197050401,Yadkin,NC,1414,1262,152
37197050402,Yadkin,NC,1334,1211,123
37197050502,Yadkin,NC,1958,1750,208
37197050503,Yadkin,NC,1501,1354,147
37197050504,Yadkin,NC,1567,1416,151
37199960101,Yancey,NC,2492,1730,762
37199960102,Yancey,NC,1076,807,269
37199960200,Yancey,NC,2709,2202,507
37199960300,Yancey,NC,2258,1406,852
37199960400,Yancey,NC,2695,1975,720
